,ast,blk,conf_abbr,drb,fg,fg2,fg2a,fg3,fg3a,fga,ft,fta,g,mp,orb,pf,player,pts,school_name,stl,tov,trb,year_max,year_min
0,2,4,SWAC,23,19,19,49,0,1,50,18,33,25,211,29,39,Austin Allen,56,Arkansas-Pine Bluff,13,11,52,2012,2012
1,8,2,WCC,33,20,9,18,11,34,52,5,10,31,191,10,23,Agustin Ambrosino,56,Brigham Young,3,13,43,2013,2013
2,5,1,Sun Belt,27,19,10,20,9,33,53,9,12,50,223,8,16,Mason Aucoin,56,Louisiana,7,11,35,2020,2017
3,13,6,Total,26,21,21,48,0,0,48,14,29,63,196,10,36,Travis Avery,56,New Orleans,7,12,36,2016,2013
4,8,0,Big South,8,20,13,36,7,15,51,9,13,17,196,1,17,Malik Battle,56,Charleston Southern,1,4,9,2020,2020
5,1,2,Big Sky,26,19,19,45,0,0,45,18,24,24,219,22,53,Shikei Blake,56,Montana State,5,13,48,2016,2016
6,7,1,Pac-12,30,23,17,35,6,17,52,4,9,28,229,5,33,J'Raan Brooks,56,Southern California,1,11,35,2019,2019
7,9,3,Patriot,47,20,19,57,1,6,63,15,35,70,371,20,65,Scott Brooks,56,Navy,13,27,67,2010,2007
8,5,1,WAC,32,20,19,50,1,3,53,15,22,9,169,14,15,Harry Brown,56,San Jose State,0,16,46,2007,2007
9,6,2,SWAC,30,24,24,50,0,0,50,8,21,41,288,22,23,Jordan Brown,56,Arkansas-Pine Bluff,7,5,52,2015,2014
10,17,9,SWAC,37,18,13,36,5,17,53,15,19,28,319,12,40,Terdarin Bryson,56,Grambling,20,24,49,2010,2010
11,4,1,Pac-10,21,19,11,26,8,24,50,10,22,40,237,10,25,Nigel Carter,56,University of California,2,11,31,2011,2009
12,35,2,OVC,38,17,9,16,8,47,63,14,22,30,348,2,54,Parker Chitty,56,Eastern Kentucky,10,27,40,2017,2017
13,27,1,MVC,19,16,14,43,2,23,66,22,31,21,233,3,29,Elijah Clarance,56,Illinois State,10,32,22,2018,2018
14,8,5,MEAC,38,15,15,32,0,2,34,26,41,19,265,13,45,James Cotton,56,Maryland-Eastern Shore,11,17,51,2010,2010
15,6,3,CUSA,30,21,15,22,6,17,39,8,14,23,215,10,16,Zach Crisler,56,Rice,5,12,40,2020,2020
16,32,4,Southland,45,21,20,41,1,9,50,13,25,30,448,26,38,Micheal Cyprien,56,Southeastern Louisiana,24,21,71,2007,2007
17,14,2,Sun Belt,17,24,24,50,0,1,51,8,18,27,184,26,39,Chandler Davis,56,Texas State,3,15,43,2019,2019
18,52,2,Big Sky,50,17,7,15,10,36,51,12,19,57,554,3,58,Julian Demalleville,56,Sacramento State,20,32,53,2013,2012
19,9,4,CUSA,19,23,23,45,0,1,46,10,24,19,228,18,27,James Dillard,56,East Carolina,8,21,37,2007,2007
20,11,1,SEC,26,20,17,40,3,6,46,13,17,52,219,13,29,Joe Duffy,56,Vanderbilt,5,12,39,2011,2008
21,12,2,AEC,17,19,11,31,8,35,66,10,14,45,343,10,23,Ross Erickson,56,Hartford,7,16,27,2011,2010
22,1,0,MEAC,6,19,3,9,16,50,59,2,2,29,148,6,13,Zieyik Estime,56,Norfolk State,1,6,12,2014,2013
23,4,3,MEAC,20,18,4,12,14,35,47,6,16,20,172,3,32,Malik Gray,56,Norfolk State,5,11,23,2015,2015
24,42,0,MAC,33,18,7,13,11,17,30,9,12,26,298,5,41,Brian Guerin,56,Bowling Green State,13,21,38,2007,2007
25,26,1,AEC,21,20,12,31,8,45,76,8,12,21,288,4,37,Robby Hanzlik,56,Maine,27,45,25,2008,2008
26,14,0,Big 12,33,21,21,50,0,3,53,14,23,27,336,17,38,Malek Harris,56,Kansas State,2,18,50,2015,2015
27,10,0,Big West,16,20,9,19,11,49,68,5,6,43,286,5,39,Rick Higgins,56,Cal Poly,10,18,21,2008,2007
28,39,0,AEC,35,20,10,22,10,27,49,6,7,16,324,4,29,Jason Hight,56,Maine,18,44,39,2008,2008
29,7,0,SWAC,14,19,9,24,10,59,83,8,12,38,202,12,31,Daniel Huggins,56,Jackson State,13,23,26,2009,2008
30,7,8,SEC,44,20,8,18,12,50,68,4,4,29,317,14,28,Aundre Hyatt,56,Louisiana State,11,10,58,2020,2020
31,6,1,Big West,11,17,11,33,6,18,51,16,25,39,161,2,8,Corey Jackson,56,Cal State Long Beach,3,14,13,2012,2011
32,16,2,OVC,27,26,26,65,0,0,65,4,9,31,309,22,34,Bobby Jolliff,56,Eastern Illinois,6,10,49,2008,2007
33,20,0,SWAC,11,18,1,4,17,62,66,3,8,56,383,6,22,Kyle Jones,56,Arkansas-Pine Bluff,8,21,17,2013,2009
34,6,5,WCC,27,17,17,53,0,0,53,22,31,40,352,24,67,Tanner Kerry,56,Pepperdine,2,16,51,2011,2010
35,5,3,Summit,33,20,11,28,9,44,72,7,10,16,210,4,13,Jaeden King,56,Western Illinois,7,11,37,2020,2020
36,16,2,A-10,33,23,13,24,10,42,66,0,1,58,306,22,32,Joe Kirby,56,Richmond,9,12,55,2018,2015
37,17,1,Big Sky,51,18,14,30,4,24,54,16,20,26,272,7,34,Donatas Kupsas,56,Weber State,4,18,58,2020,2019
38,5,0,NEC,12,20,7,15,13,28,43,3,3,19,172,2,6,Bryce Laskey,56,Saint Francis (PA),5,3,14,2020,2020
39,14,1,Big 12,14,19,7,15,12,29,44,6,8,47,209,14,22,Derrek Lewis,56,Texas A&M,4,11,28,2011,2008
40,12,0,WAC,11,18,7,18,11,29,47,9,13,6,174,0,17,Isaiah Lewis,56,Chicago State,3,14,11,2020,2020
41,11,2,A-10,26,22,17,32,5,17,49,7,14,47,364,17,45,Arvydas Lidzius,56,Saint Joseph's,3,17,43,2008,2007
42,11,0,MWC,12,20,18,27,2,21,48,14,24,8,141,6,9,Thomas Manzano,56,Wyoming,4,6,18,2010,2010
43,23,2,Big Sky,58,22,15,30,7,37,67,5,10,30,368,12,44,Rodrick McCobb,56,Northern Colorado,7,17,70,2020,2020
44,35,3,WCC,31,23,22,46,1,6,52,9,16,28,388,24,23,Brandon McGhee,56,Pacific,22,16,55,2019,2019
45,16,2,WAC,15,19,8,21,11,52,73,7,11,25,246,1,24,L.J. McIntosh,56,Texas-Rio Grande Valley,12,12,16,2014,2014
46,1,14,MWC,30,24,24,59,0,0,59,8,14,36,217,6,36,Joel Mensah,56,San Diego State,5,7,36,2020,2019
47,1,14,SEC,17,25,21,41,4,8,49,2,8,23,161,18,20,Dwight Miller,56,Tennessee,6,4,35,2012,2012
48,14,6,MAAC,37,21,20,60,1,2,62,13,20,60,322,25,43,Robbie Myers,56,Rider,9,22,62,2010,2007
49,8,1,Summit,23,22,22,45,0,2,47,12,23,43,318,31,61,Andy Nagel,56,North Dakota State,2,14,54,2011,2010
50,6,9,CUSA,45,22,22,52,0,1,53,12,34,51,283,30,60,Pierre Niles,56,Memphis,10,20,75,2008,2007
51,3,1,AAC,25,21,21,44,0,0,44,14,26,22,203,28,45,Arashma Parks,56,Temple,4,17,53,2020,2020
52,1,6,SEC,34,22,21,28,1,11,39,11,14,24,217,13,25,Mike Peake,56,Georgia,3,14,47,2020,2020
53,14,3,Southern,12,20,14,33,6,16,49,10,18,21,141,13,22,Anthony Phillip,56,Western Carolina,6,10,25,2011,2010
54,11,2,A-Sun,23,20,15,45,5,22,67,11,21,36,277,17,34,Shane Porchea,56,South Carolina Upstate,6,16,40,2012,2011
55,2,2,Horizon,18,19,19,30,0,0,30,18,28,15,137,21,20,Jelani Poston,56,Illinois-Chicago,3,10,39,2009,2009
56,7,0,Horizon,3,18,9,20,9,36,56,11,14,19,146,4,12,Tyrese Potoma,56,Cleveland State,2,16,7,2020,2020
57,6,1,Sun Belt,9,19,1,3,18,55,58,0,0,49,158,1,7,Lance Richard,56,Louisiana-Monroe,6,9,10,2018,2015
58,28,9,SEC,32,19,19,37,0,9,46,18,24,30,266,21,20,Luis Rodriguez,56,Mississippi,10,10,53,2020,2019
59,7,1,Horizon,18,18,8,21,10,28,49,10,15,18,147,3,8,Eric Schiele,56,Cleveland State,9,13,21,2009,2008
60,8,2,WCC,46,21,21,37,0,0,37,14,32,51,260,29,41,Braiden Shaw,56,Brigham Young,14,14,75,2018,2016
61,20,3,AEC,25,21,15,30,6,21,51,8,11,32,292,5,41,Jordan Shea,56,Massachusetts-Lowell,7,16,30,2017,2015
62,5,10,Pac-12,21,26,26,45,0,0,45,4,7,29,211,15,36,Roman Silva,56,Oregon State,3,10,36,2020,2020
63,25,0,MAC,38,20,20,44,0,1,45,16,28,54,538,15,82,Reynold Walters,56,Central Michigan,21,41,53,2008,2007
64,4,7,OVC,35,20,10,19,10,31,50,6,9,28,221,21,35,Ja'Cori Wilson,56,Morehead State,7,13,56,2019,2019
65,28,1,Patriot,32,14,14,29,0,1,30,28,41,44,324,13,55,Matthew Wilson,56,American,4,23,45,2010,2009
66,6,13,MAC,39,23,22,50,1,4,54,8,22,34,224,29,46,Brian Addison,55,Buffalo,5,14,68,2009,2008
67,4,2,Total,35,18,9,17,9,27,44,10,15,18,167,8,17,Galen Alexander,55,Total,3,13,43,2020,2018
68,6,2,CAA,14,14,9,25,5,15,40,22,23,31,141,5,21,Allen Aragbaye,55,Northeastern,6,14,19,2009,2008
69,17,4,Big East,55,19,11,24,8,45,69,9,22,93,563,29,71,Ted Bancroft,55,Providence,27,25,84,2015,2011
70,48,2,Southland,22,15,11,25,4,25,50,21,31,15,252,4,22,Ryan Bennett,55,Sam Houston State,15,33,26,2008,2008
71,15,10,MAAC,40,18,9,22,9,37,59,10,18,25,349,11,43,Klay Brown,55,Saint Peter's,19,24,51,2019,2019
72,41,1,CAA,24,22,15,42,7,40,82,4,9,31,405,3,25,Vernon Carr,55,Towson,15,26,27,2009,2008
73,33,4,AAC,12,22,19,49,3,10,59,8,11,20,217,3,22,D'Marnier Cunningham,55,Memphis,15,22,15,2015,2015
74,10,5,CUSA,76,22,22,53,0,0,53,11,26,51,641,57,96,Joe Ebondo,55,Old Dominion,16,23,133,2015,2014
75,9,4,Big Sky,47,16,7,27,9,26,53,14,21,28,219,5,34,Eddy Egun,55,Montana,5,18,52,2020,2020
76,16,24,A-Sun,43,24,24,46,0,1,47,7,16,29,309,29,53,Oladapo Fagbenle,55,Campbell,8,21,72,2008,2008
77,5,4,CUSA,28,16,16,31,0,0,31,23,36,45,319,19,73,Bahrom Firozgary,55,Rice,3,19,47,2014,2013
78,4,8,OVC,37,18,18,38,0,0,38,19,31,51,338,19,74,Terron Gilmore,55,Murray State,11,25,56,2016,2013
79,1,8,CUSA,20,24,24,37,0,3,40,7,14,13,106,17,18,Marcus Goode,55,Marshall,3,9,37,2009,2009
80,5,1,GWC,34,16,9,22,7,24,46,16,19,14,224,6,23,Spencer Goodman,55,North Dakota,4,18,40,2012,2011
81,4,1,WAC,10,19,3,8,16,41,49,1,2,22,138,1,2,Gabe Hadley,55,New Mexico State,2,4,11,2018,2018
82,4,15,Big Ten,29,25,25,41,0,1,42,5,17,30,257,23,32,Brady Heiman,55,Nebraska,3,7,52,2019,2019
83,1,6,Southern,25,21,15,43,6,21,64,7,12,33,196,13,13,Cody Henegar,55,North Carolina-Greensboro,2,8,38,2012,2011
84,20,0,NEC,23,21,16,42,5,21,63,8,18,30,293,7,23,Brandon Herman,55,Robert Morris,8,19,30,2012,2012
85,4,23,Total,30,24,24,46,0,0,46,7,17,44,242,23,43,Alex Holcombe,55,Total,3,10,53,2019,2017
86,3,2,A-Sun,25,22,21,41,1,5,46,10,19,28,206,7,37,Colin Hunt,55,Campbell,7,29,32,2007,2007
87,8,19,NEC,47,22,20,40,2,9,49,9,13,30,511,61,70,Jordan Ingram,55,Fairleigh Dickinson,6,18,108,2007,2007
88,38,0,A-Sun,23,17,15,33,2,10,43,19,32,28,295,5,38,Terry Ivery,55,Stetson,16,28,28,2020,2020
89,8,4,SWAC,14,21,16,35,5,21,56,8,17,27,205,11,24,Zachary Jackson,55,Alabama A&M,7,10,25,2016,2015
90,22,0,NEC,15,17,5,17,12,33,50,9,12,45,263,5,38,Tyler Jones,55,Fairleigh Dickinson,18,23,20,2019,2018
91,3,3,Total,26,21,21,51,0,4,55,13,18,48,326,20,63,Ivan Jurkovic,55,Florida International,5,23,46,2014,2013
92,6,18,Southland,31,24,24,50,0,2,52,7,11,14,190,16,22,Konstantin Kulikov,55,Incarnate Word,2,19,47,2018,2018
93,38,2,Summit,25,18,14,28,4,11,39,15,15,28,443,4,59,Joel Lindberg,55,North Dakota State,7,18,29,2012,2012
94,17,0,Sun Belt,21,16,5,18,11,34,52,12,15,31,250,1,18,K.J. Malveau,55,Texas State,8,23,22,2016,2016
95,35,3,Ivy,30,14,7,26,7,35,61,20,28,46,371,4,29,Mack McKearney,55,Dartmouth,18,25,34,2013,2012
96,6,1,WAC,22,24,22,55,2,11,66,5,17,30,240,15,27,Kevin McNeal,55,Cal State Bakersfield,6,16,37,2019,2019
97,21,8,MWC,40,17,10,23,7,25,48,14,21,18,252,23,18,Grayson Moore,55,Utah State,8,13,63,2016,2016
98,4,4,MVC,35,21,21,61,0,1,62,13,28,22,267,24,54,Jermaine Morgan,55,Bradley,9,20,59,2015,2015
99,12,2,Southland,21,21,10,32,11,33,65,2,8,38,294,7,29,Marquis Nelson,55,Nicholls State,7,25,28,2016,2015
100,8,3,Sun Belt,22,23,18,37,5,20,57,4,7,25,265,8,33,Brandon Nichols,55,Little Rock,3,20,30,2007,2007
101,7,17,Big Sky,31,21,21,44,0,0,44,13,25,30,265,21,46,Ben Olayinka,55,Northern Arizona,3,21,52,2013,2012
102,11,0,Southern,10,18,8,16,10,17,33,9,11,17,133,1,21,D.J. Peavy,55,Mercer,3,13,11,2019,2019
103,14,1,Big West,29,18,12,29,6,27,56,13,20,29,296,15,12,Ben Pemberton,55,Pacific,3,18,44,2007,2007
104,17,1,Big West,48,16,15,44,1,1,45,22,34,50,476,45,67,Christian Peterson,55,UC-Santa Barbara,16,26,93,2012,2010
105,3,0,MEAC,21,21,9,25,12,44,69,1,4,33,198,12,10,Reggie Price,55,Hampton,5,11,33,2014,2013
106,26,1,Patriot,21,17,13,41,4,13,54,17,24,39,293,3,22,De'Vaughn Reid,55,Holy Cross,9,23,24,2015,2013
107,10,5,Big East,47,21,21,54,0,0,54,13,27,26,329,26,50,Melvyn Richardson,55,South Florida,10,25,73,2007,2007
108,30,2,Total,22,19,12,30,7,31,61,10,19,29,227,4,24,Da'Shawn Robinson,55,Total,12,11,26,2018,2016
109,9,1,Ivy,10,20,12,24,8,18,42,7,14,21,237,8,29,Matt Sargeant,55,Princeton,5,25,18,2008,2007
110,5,1,Big South,15,17,0,3,17,47,50,4,6,22,115,7,12,Raivis Scerbinskis,55,Winthrop,1,4,22,2019,2018
111,40,0,Horizon,17,21,13,35,8,33,68,5,7,25,334,7,30,Edgar Segura,55,Green Bay,8,29,24,2008,2008
112,28,1,MVC,26,20,20,50,0,10,60,15,21,33,333,4,37,Antonio Thomas,55,Bradley,9,20,30,2020,2020
113,5,8,A-10,35,22,22,35,0,0,35,11,22,36,225,22,43,Khalea Turner-Morris,55,Massachusetts,1,15,57,2019,2018
114,5,0,Big 12,16,21,19,38,2,5,43,11,17,24,161,8,14,Marcus Watkins,55,Missouri,9,6,24,2007,2007
115,5,0,OVC,11,18,3,6,15,33,39,4,5,19,133,1,4,Alton Williams,55,Austin Peay,2,1,12,2012,2011
116,4,22,Big West,37,20,20,55,0,0,55,15,26,36,281,22,72,LaRond Williams,55,Cal State Long Beach,10,25,59,2018,2017
117,32,1,Sun Belt,32,18,15,33,3,19,52,16,29,56,395,4,42,Tiremone Williams,55,Louisiana,18,21,36,2016,2015
118,2,1,Sun Belt,17,21,18,43,3,7,50,10,19,19,122,14,41,Tyrek Williams,55,Troy,3,24,31,2020,2020
119,6,1,Big South,12,14,14,29,0,1,30,27,36,18,158,21,16,Jihad Wright,55,Campbell,4,6,33,2012,2012
120,7,12,Southland,31,25,25,50,0,0,50,5,10,45,264,18,53,Arthur Zulu,55,Sam Houston State,9,15,49,2010,2009
121,5,3,Mid-Cont,25,20,13,33,7,24,57,7,15,26,215,8,32,Junior Abrahao,54,Southern Utah,4,10,33,2007,2007
122,18,0,Big South,15,16,7,15,9,32,47,13,17,42,176,2,13,Drew Absher,54,Virginia Military Institute,2,15,17,2014,2011
123,3,6,Big West,29,21,21,56,0,0,56,12,18,27,276,25,36,Sean Anderson,54,UC-Riverside,8,9,54,2007,2007
124,6,24,MEAC,83,19,19,44,0,0,44,16,22,45,352,27,73,Princewill Anosike,54,Howard,9,31,110,2020,2019
125,0,3,OVC,16,19,19,30,0,0,30,16,25,24,183,16,25,Tariq Balogun,54,Eastern Kentucky,2,4,32,2020,2020
126,6,0,Ivy,31,18,15,28,3,20,48,15,22,43,207,11,23,Elijah Barnes,54,Princeton,6,16,42,2020,2018
127,5,0,Big South,5,21,14,22,7,18,40,5,10,45,91,8,3,Kellen Blake,54,Winthrop,4,4,13,2018,2015
128,9,5,SWAC,16,18,13,41,5,20,61,13,18,22,191,8,23,Quinton Brigham,54,Texas Southern,6,22,24,2020,2020
129,26,1,CUSA,28,19,19,52,0,9,61,16,24,34,326,14,33,Devorious Brown,54,Florida Atlantic,18,31,42,2018,2017
130,12,0,WCC,31,17,7,30,10,39,69,10,13,16,264,11,21,Crisshawn Clark,54,Portland,6,14,42,2019,2019
131,6,5,AEC,14,22,19,35,3,14,49,7,13,23,200,12,19,Matt Conway,54,Albany (NY),1,8,26,2018,2018
132,20,8,ACC,30,23,22,47,1,7,54,7,17,21,353,32,52,Keaton Copeland,54,Miami (FL),22,15,62,2007,2007
133,12,0,Big South,25,18,3,6,15,42,48,3,4,47,188,6,13,Mitchell Deter,54,Charleston Southern,3,7,31,2014,2011
134,5,8,Big Ten,30,23,23,52,0,5,57,8,16,57,361,19,51,Gaston Diedhiou,54,Minnesota,7,12,49,2018,2015
135,13,3,Big Ten,20,17,12,28,5,30,58,15,20,28,325,9,29,Charlie Easley,54,Nebraska,18,14,29,2020,2020
136,8,1,Horizon,8,19,7,20,12,30,50,4,4,27,183,5,20,Brent Eaton,54,Green Bay,5,10,13,2009,2009
137,21,4,Big South,56,20,20,38,0,1,39,14,31,15,328,38,30,Vj Fails,54,Charleston Southern,8,15,94,2007,2007
138,12,5,MAAC,38,22,21,60,1,5,65,9,12,28,401,23,49,Brad Farrell,54,Loyola (MD),13,24,61,2009,2009
139,13,27,Southland,50,22,22,47,0,3,50,10,13,28,304,11,57,Joel Fiegler,54,Central Arkansas,8,35,61,2015,2015
140,1,4,MWC,45,22,22,35,0,0,35,10,23,23,192,31,28,Brian Gibson,54,Wyoming,7,6,76,2011,2011
141,2,17,MEAC,31,21,20,41,1,14,55,11,18,26,241,29,41,Jordan Hardwick,54,Coppin State,5,21,60,2020,2018
142,15,3,AAC,27,18,12,33,6,21,54,12,27,23,271,3,26,Tae Hardy,54,East Carolina,12,13,30,2019,2019
143,42,1,OVC,21,15,11,26,4,14,40,20,29,25,350,6,25,Hank Harris,54,Southeast Missouri State,27,23,27,2008,2008
144,12,5,Big South,24,22,22,37,0,1,38,10,20,25,215,17,39,Toles Hartman,54,North Carolina-Asheville,4,16,41,2011,2011
145,2,3,Big Sky,37,19,19,42,0,0,42,16,29,51,197,16,36,James Herrick,54,Sacramento State,2,14,53,2018,2015
146,3,60,WAC,59,23,23,44,0,0,44,8,20,32,383,24,65,Justin Hollins,54,Cal State Bakersfield,7,24,83,2016,2016
147,15,0,A-Sun,19,17,14,31,3,9,40,17,27,16,190,5,18,Brian Holmes,54,North Florida,6,30,24,2011,2011
148,4,4,Ivy,14,21,11,37,10,27,64,2,2,27,235,2,14,Nick Jackson,54,Dartmouth,6,19,16,2012,2011
149,4,0,MEAC,7,23,19,39,4,8,47,4,6,16,126,7,13,Mahir Johnson,54,Delaware State,3,10,14,2017,2016
150,3,3,Sun Belt,32,19,12,25,7,24,49,9,17,43,282,14,38,Austin Karazsia,54,South Alabama,4,11,46,2015,2014
151,8,3,NEC,28,20,16,46,4,12,58,10,18,43,277,13,54,Harrison Kay,54,Central Connecticut State,5,23,41,2019,2017
152,51,0,AEC,23,23,22,62,1,17,79,7,16,31,519,10,38,Jarrel Lane,54,Maryland-Baltimore County,22,46,33,2013,2012
153,14,0,Summit,10,16,8,23,8,33,56,14,21,25,192,4,6,Zach Monaghan,54,South Dakota State,4,20,14,2012,2012
154,4,4,Mid-Cont,,21,21,37,0,4,41,12,22,28,,,,Jeff Montague,54,Centenary (LA),9,,44,2007,2007
155,3,4,Big Sky,21,21,15,23,6,16,39,6,8,25,93,7,12,Brenden Morris,54,Weber State,6,3,28,2020,2017
156,9,9,Summit,48,20,14,43,6,38,81,8,13,41,449,13,71,Abdou Niang,54,Western Illinois,3,25,61,2011,2010
157,6,0,MAAC,27,24,24,40,0,0,40,6,8,27,209,14,37,Greg Noack,54,Monmouth,10,8,41,2014,2014
158,5,31,Big East,30,23,23,42,0,0,42,8,27,30,292,31,63,Augustine Okosun,54,Seton Hall,8,13,61,2008,2008
159,9,14,MAAC,30,23,22,34,1,9,43,7,10,30,254,16,44,Julian Powell,54,Saint Peter's,8,15,46,2018,2018
160,3,7,Southern,37,15,15,36,0,0,36,24,42,38,269,15,54,Domas Rinksalis,54,Wofford,5,12,52,2012,2010
161,7,11,A-Sun,17,23,21,60,2,9,69,6,9,40,209,14,17,Chris Rozier,54,Jacksonville,4,16,31,2011,2010
162,22,0,OVC,20,15,14,37,1,5,42,23,27,26,334,6,21,Isaac Smith,54,Eastern Illinois,6,24,26,2011,2011
163,19,1,AEC,33,14,12,42,2,20,62,24,42,67,396,10,27,Sherrod Smith,54,Boston University,11,18,43,2010,2007
164,80,1,MEAC,47,16,10,34,6,18,52,16,27,29,538,18,52,Tyvoris Soloman,54,South Carolina State,25,37,65,2015,2015
165,5,2,WAC,23,22,22,53,0,0,53,10,16,12,149,19,21,Dazmond Starke,54,Idaho,5,16,42,2012,2012
166,20,0,Summit,35,22,21,45,1,7,52,9,14,56,363,7,31,Payton Tivis,54,South Dakota State,10,17,42,2011,2009
167,9,6,Pac-12,38,17,6,19,11,22,41,9,17,40,348,5,39,Elias Valtonen,54,Arizona State,12,16,43,2020,2019
168,16,10,Total,51,20,16,33,4,19,52,10,17,44,252,14,46,Toby Van Ry,54,Total,3,24,65,2019,2016
169,11,1,Big Ten,29,20,11,24,9,20,44,4,6,53,177,2,17,Eso Akunne,53,Michigan,1,8,31,2013,2010
170,6,2,Big West,43,19,19,39,0,0,39,15,26,16,262,25,24,Benoit Bekono,53,UC-Riverside,12,20,68,2008,2007
171,20,7,WCC,41,20,18,30,2,10,40,11,23,31,343,19,46,Kyle Bowen,53,Saint Mary's (CA),8,13,60,2020,2020
172,12,1,OVC,16,19,14,32,5,16,48,10,28,20,236,13,22,DeAndre Bynum,53,Jacksonville State,4,11,29,2011,2011
173,21,0,CUSA,23,17,10,30,7,20,50,12,19,23,265,3,15,D'Von Campbell,53,Texas-El Paso,8,22,26,2012,2012
174,22,8,WCC,32,21,17,45,4,22,67,7,19,55,483,21,46,Tyler Carr,53,Pepperdine,19,23,53,2008,2007
175,8,6,Southland,25,19,19,41,0,0,41,15,27,21,177,15,35,Billy Cotton,53,McNeese State,8,26,40,2009,2009
176,3,13,NEC,24,21,19,49,2,16,65,9,19,18,176,11,21,Rickie Crews,53,Monmouth,9,16,35,2008,2007
177,21,4,Pac-12,45,20,20,39,0,1,40,13,30,52,381,22,80,Matt Dahlen,53,Oregon State,10,23,67,2017,2015
178,0,2,SWAC,17,18,17,45,1,1,46,16,28,10,147,10,27,Chris Davenport,53,Alcorn State,7,14,27,2011,2011
179,1,9,Patriot,47,22,22,54,0,0,54,9,25,42,335,24,72,John Fenton,53,Colgate,6,14,71,2015,2014
180,12,13,CUSA,59,24,24,42,0,1,43,5,8,20,248,23,33,Max Fiedler,53,Rice,6,17,82,2020,2020
181,37,3,OVC,57,19,18,59,1,13,72,14,36,56,598,31,60,Taylor Filipek,53,Eastern Kentucky,11,25,88,2012,2011
182,1,0,MEAC,24,17,10,19,7,23,42,12,14,24,128,9,23,BJ Fitzgerald,53,Norfolk State,4,7,33,2019,2019
183,5,2,OVC,17,20,11,18,9,30,48,4,8,21,137,1,9,Justice Green,53,Eastern Illinois,9,3,18,2018,2018
184,5,2,Sun Belt,13,17,4,7,13,34,41,6,13,24,158,6,31,Breki Gylfason,53,Appalachian State,1,10,19,2019,2019
185,33,0,Southern,11,17,9,21,8,21,42,11,14,27,207,5,15,Jerry Higgins III,53,Citadel,14,15,16,2020,2019
186,3,29,Mid-Cont,43,21,21,68,0,0,68,11,20,28,277,23,37,Brad Kanis,53,Southern Utah,0,12,66,2007,2007
187,8,11,MAAC,28,21,16,26,5,11,37,6,9,29,309,29,53,Ali Langford,53,Niagara,17,14,57,2012,2012
188,33,0,Southland,17,23,22,40,1,10,50,6,15,27,286,3,33,Shelby Lewis,53,Stephen F. Austin,16,30,20,2007,2007
189,93,5,Total,46,18,11,48,7,25,73,10,20,82,806,4,103,Steve Martin,53,Chicago State,22,89,50,2011,2008
190,4,8,AEC,35,21,20,47,1,2,49,10,14,29,182,9,36,Erik Nissen,53,Maine,4,13,44,2015,2014
191,5,0,OVC,36,20,15,25,5,19,44,8,19,56,364,23,72,Samson Oyediran,53,Tennessee State,4,20,59,2018,2016
192,22,0,Total,6,14,9,24,5,16,40,20,30,36,208,9,17,Brandon Price,53,Western Kentucky,7,22,15,2015,2014
193,8,3,Big South,13,19,5,13,14,38,51,1,2,21,172,8,17,Chris Shelton,53,Hampton,4,3,21,2020,2020
194,25,10,Big East,31,22,19,36,3,26,62,6,17,46,411,19,48,Brandon Slater,53,Villanova,13,17,50,2020,2019
195,13,5,Sun Belt,26,21,17,28,4,13,41,7,9,27,332,19,39,Coleman Sparling,53,Texas-Arlington,11,8,45,2020,2020
196,4,2,MEAC,8,20,10,19,10,26,45,3,3,34,136,8,28,Kevin Sumner,53,Hampton,4,16,16,2008,2007
197,15,0,Big Sky,9,16,16,25,0,11,36,21,35,39,150,9,36,Lyle Sutton,53,Idaho State,10,7,18,2020,2018
198,3,2,Sun Belt,22,18,16,29,2,5,34,15,21,23,159,8,20,Drew Tennial,53,Texas State,9,8,30,2020,2020
199,5,3,Big South,22,18,5,11,13,38,49,4,7,15,159,0,21,Lance Terry,53,Gardner-Webb,7,13,22,2020,2020
200,5,1,CUSA,44,15,6,14,9,32,46,14,24,42,282,13,36,Christian Thieneman,53,Marshall,2,9,57,2019,2017
201,26,3,Pac-12,40,11,10,28,1,7,35,30,55,39,374,17,54,Cameron Walker,53,Stanford,8,26,57,2017,2016
202,6,9,Total,23,23,23,48,0,0,48,7,24,30,208,30,42,James Watson,53,Total,3,11,53,2012,2010
203,13,3,Horizon,20,13,11,38,2,5,43,25,36,19,254,16,16,Trinson White,53,Milwaukee,5,16,36,2015,2015
204,12,10,AEC,57,20,18,43,2,13,56,11,20,46,351,18,36,Dave Wiegmann,53,Albany (NY),7,18,75,2014,2013
205,4,13,A-Sun,25,20,20,27,0,0,27,13,28,21,225,26,35,Curtis Wilkinson,53,East Tennessee State,5,11,51,2011,2011
206,18,1,CUSA,43,20,18,32,2,16,48,11,34,51,442,14,61,Adam Williams,53,Marshall,16,16,57,2009,2008
207,14,5,WCC,35,18,12,29,6,25,54,11,20,43,257,14,36,DuBois Williams,53,Saint Mary's (CA),10,20,49,2008,2007
208,4,2,MEAC,18,21,21,47,0,1,48,11,19,10,160,12,24,Leon Williams,53,Florida A&M,5,9,30,2017,2017
209,28,1,SWAC,26,20,16,36,4,14,50,9,19,23,307,13,29,Brandon Wright,53,Alabama A&M,12,20,39,2019,2019
210,15,0,MAC,24,16,13,43,3,11,54,18,23,24,255,7,30,Davin Zeigler,53,Bowling Green State,8,20,31,2020,2020
211,42,2,WCC,26,14,10,31,4,14,45,20,34,44,438,5,45,Troy Alexander,52,Santa Clara,22,50,31,2010,2009
212,20,3,ACC,24,18,11,35,7,20,55,9,15,35,222,1,15,Marco Anthony,52,Virginia,2,14,25,2019,2018
213,5,0,MAC,11,17,6,15,11,33,48,7,8,14,195,1,23,Ali Barnes,52,Miami (OH),4,10,12,2016,2016
214,16,0,MAAC,13,15,11,25,4,17,42,18,25,10,227,5,14,Davonte Beard,52,Siena,7,18,18,2012,2012
215,9,5,Total,32,22,22,46,0,5,51,8,15,72,286,26,59,Phil Benson,52,Total,4,21,58,2011,2007
216,5,7,CUSA,25,16,5,16,11,43,59,9,13,46,232,6,45,Cameron Blakley,52,Charlotte,4,14,31,2016,2014
217,30,0,WAC,28,17,9,20,8,46,66,10,16,23,390,3,40,Jacobby Bledsoe,52,Missouri-Kansas City,24,18,31,2014,2014
218,27,0,Ivy,27,18,11,23,7,37,60,9,14,30,329,1,33,Luke Bolster,52,Columbia,11,24,28,2020,2018
219,4,2,CAA,25,22,17,32,5,17,49,3,10,28,234,16,27,John Bowen,52,North Carolina-Wilmington,8,5,41,2020,2020
220,0,22,Sun Belt,24,18,18,40,0,1,41,16,26,28,245,22,37,Rory Burt,52,Louisiana-Monroe,4,13,46,2010,2010
221,4,8,MEAC,17,18,9,36,9,28,64,7,11,28,181,9,21,Chasen Campbell,52,South Carolina State,1,14,26,2014,2013
222,17,5,WCC,28,21,18,57,3,17,74,7,23,42,346,15,27,Marcus Carter,52,Portland,5,32,43,2008,2007
223,5,1,SWAC,22,20,20,42,0,0,42,12,20,17,141,15,27,Mark Carter,52,Alcorn State,9,6,37,2020,2020
224,3,2,Southern,4,19,15,21,4,5,26,10,17,18,88,4,11,Antoine Childs,52,Western Carolina,4,6,8,2010,2009
225,12,3,Big 12,37,19,13,28,6,29,57,8,14,70,370,15,39,Javon Coney,52,Colorado,7,11,52,2011,2008
226,42,1,Big Sky,25,18,15,42,3,11,53,13,21,29,438,7,42,Russell Daniels,52,Montana State,12,33,32,2019,2019
227,18,0,Big South,12,18,3,4,15,46,50,1,3,40,228,1,14,Tyler Deihl,52,Presbyterian,1,20,13,2012,2011
228,5,2,MAAC,27,17,11,31,6,18,49,12,18,22,172,16,25,Martin Dixon-Green,52,Canisius,4,14,43,2017,2017
229,6,1,Southland,8,17,5,10,12,33,43,6,8,11,156,3,13,Kyle Ford,52,Nicholls State,1,10,11,2009,2009
230,26,0,ACC,19,15,11,46,4,20,66,18,26,16,218,1,18,Jeremiah Francis,52,North Carolina,7,19,20,2020,2020
231,29,0,SEC,19,17,7,24,10,37,61,8,12,47,340,1,20,Mark French,52,Texas A&M,9,18,20,2020,2017
232,13,0,Horizon,9,18,6,25,12,47,72,4,6,35,229,3,6,Jordan Gorman,52,Detroit Mercy,9,11,12,2020,2019
233,2,5,A-Sun,28,20,20,41,0,0,41,12,18,39,208,18,41,Ricky Gouety,52,Stetson,5,17,46,2020,2019
234,10,0,MVC,12,18,4,11,14,37,48,2,2,19,164,4,8,Marcus Henderson,52,Evansville,4,7,16,2020,2020
235,9,10,Southern,49,17,14,40,3,11,51,15,25,50,464,48,98,Taylor Hoffer,52,North Carolina-Greensboro,9,22,97,2013,2011
236,6,0,Sun Belt,11,17,5,13,12,34,47,6,9,25,179,4,23,Curtis Jackson,52,Little Rock,1,9,15,2009,2009
237,6,3,Big Sky,30,20,18,34,2,10,44,10,17,31,228,16,34,Elijah Jackson,52,Eastern Washington,10,12,46,2020,2019
238,0,8,Big East,20,19,19,38,0,0,38,14,31,21,165,23,22,Kevin Johnson,52,Seton Hall,4,7,43,2013,2013
239,9,0,SWAC,17,16,7,21,9,20,41,11,15,22,180,6,24,Antonio Jones,52,Alcorn State,11,18,23,2009,2009
240,46,1,MEAC,25,12,11,28,1,9,37,27,36,31,309,4,29,Phillip Jones,52,Howard,9,46,29,2020,2018
241,6,0,A-10,8,18,2,6,16,43,49,0,0,36,157,4,20,Colby Lewis,52,Charlotte,2,6,12,2013,2010
242,7,1,Patriot,19,19,19,34,0,0,34,14,15,26,204,26,29,Mo Lewis,52,Navy,5,7,45,2018,2017
243,16,0,MAAC,11,21,21,45,0,3,48,10,16,8,160,7,10,Savion Lewis,52,Quinnipiac,4,15,18,2020,2020
244,34,0,Big 12,30,22,18,42,4,19,61,4,6,24,287,4,33,Stargell Love,52,Baylor,9,34,34,2011,2011
245,35,2,A-10,12,19,17,34,2,9,43,12,24,8,205,10,17,Jon Lucky,52,Rhode Island,5,21,22,2007,2007
246,7,4,Southland,19,19,7,22,12,23,45,2,5,26,249,4,31,Dylon Maggio,52,Southeastern Louisiana,8,24,23,2015,2015
247,8,0,NEC,14,16,10,28,6,20,48,14,19,19,168,5,20,Ruandy Melo,52,St. Francis (NY),10,21,19,2007,2007
248,4,3,Southland,27,24,24,52,0,1,53,4,8,40,215,25,27,Alexsander Milosavljevic,52,Abilene Christian,1,16,52,2015,2014
249,5,3,MEAC,7,21,12,23,9,23,46,1,3,19,131,6,16,Trushaun Moorer,52,South Carolina State,1,8,13,2020,2020
250,8,1,MEAC,19,19,10,27,9,21,48,5,11,27,233,4,37,Isaac Nixon,52,Norfolk State,7,28,23,2010,2010
251,17,0,Southern,27,17,3,7,14,39,46,4,6,59,396,1,43,Aaron O'Neill,52,Furman,5,9,28,2015,2012
252,14,1,SWAC,22,15,5,27,10,42,69,12,29,64,321,5,39,Antonio Ootesey,52,Arkansas-Pine Bluff,12,24,27,2011,2008
253,6,3,NEC,22,23,23,53,0,3,56,6,8,29,259,13,31,Brad Piehl,52,Robert Morris,6,23,35,2010,2010
254,5,1,Big West,6,15,4,18,11,39,57,11,17,27,196,6,24,Ryker Pierce,52,UC-Riverside,8,5,12,2019,2018
255,28,7,NEC,28,19,15,37,4,15,52,10,31,40,475,27,50,Tyler Plummer,52,Wagner,17,36,55,2019,2018
256,28,0,Big Sky,27,15,11,29,4,14,43,18,25,8,186,5,20,Antoine Proctor,52,Sacramento State,11,25,32,2011,2011
257,3,0,OVC,8,21,19,32,2,10,42,8,16,26,165,7,8,Chris Reaves,52,Austin Peay,2,6,15,2010,2010
258,13,0,Big West,7,19,15,38,4,23,61,10,18,26,202,9,24,Jared Rice,52,Cal Poly,3,13,16,2020,2019
259,18,0,SWAC,31,20,10,21,10,19,40,2,7,26,338,7,25,Patrick Rucker,52,Mississippi Valley State,8,25,38,2019,2019
260,11,1,Horizon,12,20,14,38,6,28,66,6,9,29,198,9,27,Tyrone Scott,52,Wright State,3,16,21,2007,2007
261,12,15,MEAC,48,22,21,62,1,5,67,7,25,36,431,26,78,Kam Shepherd,52,North Carolina A&T,11,42,74,2009,2008
262,10,0,MEAC,17,19,8,26,11,37,63,3,9,44,249,8,32,Mike Simpson,52,Coppin State,5,26,25,2013,2011
263,41,1,Sun Belt,24,17,9,22,8,17,39,10,14,20,285,0,36,Raymond Sims,52,South Alabama,17,42,24,2011,2010
264,9,1,OVC,14,15,1,8,14,39,47,8,10,30,255,0,20,Giovanni Smith,52,Jacksonville State,4,5,14,2014,2013
265,23,4,Horizon,30,17,7,16,10,39,55,8,15,32,367,4,31,Reinaldo Smith,52,Wright State,10,18,34,2007,2007
266,4,0,Big East,5,18,11,24,7,23,47,9,17,32,73,5,8,Josh Sowards,52,West Virginia,1,1,10,2009,2008
267,12,2,A-10,17,20,16,34,4,22,56,8,13,17,214,11,30,Solly Stansbury,52,Richmond,12,12,28,2018,2018
268,11,2,CAA,15,17,16,28,1,2,30,17,22,34,227,11,25,Chris Stratton,52,William & Mary,4,15,26,2008,2007
269,3,5,Big 12,45,19,19,32,0,0,32,14,42,28,215,26,23,Austin Trice,52,Kansas State,2,8,71,2019,2019
270,31,4,WAC,22,16,9,21,7,26,47,13,20,25,239,2,31,James Walker,52,Utah State,11,18,24,2011,2011
271,30,1,Total,23,24,24,52,0,6,58,4,7,24,363,8,37,Aaron Washington,52,Missouri-Kansas City,14,21,31,2014,2013
272,6,16,A-Sun,50,21,20,50,1,18,68,9,19,44,302,16,26,Logan Windeler,52,North Alabama,8,21,66,2020,2019
273,5,5,MAC,21,21,21,41,0,0,41,10,16,27,340,15,42,Eric Wormely,52,Ball State,4,20,36,2009,2009
274,7,1,MWC,9,12,5,17,7,16,33,20,27,26,116,1,15,Mike Annese,51,Colorado State,7,14,10,2010,2009
275,3,0,OVC,13,17,16,32,1,5,37,16,26,23,138,15,15,Will Bailey,51,Morehead State,6,10,28,2012,2012
276,10,2,Southland,54,22,22,47,0,0,47,7,21,13,254,26,39,Miles Banks,51,Incarnate Word,3,14,80,2017,2017
277,14,1,Horizon,10,16,6,13,10,17,30,9,10,30,172,4,20,Tyler Behrendt,51,Milwaukee,7,10,14,2020,2019
278,14,5,CUSA,29,22,22,48,0,0,48,7,14,31,321,16,24,Charles Belton,51,Rice,7,18,45,2007,2007
279,12,0,MAAC,6,15,2,10,13,41,51,8,9,28,246,7,15,Bob Bevilacqua,51,Canisius,6,10,13,2010,2010
280,16,2,A-Sun,9,13,3,12,10,18,30,15,25,18,125,1,13,Sean Brennan,51,North Florida,6,15,10,2014,2014
281,25,7,A-Sun,32,19,19,60,0,1,61,13,23,58,513,24,48,Rob Elam,51,South Carolina Upstate,13,19,56,2013,2012
282,34,2,MWC,40,10,7,27,3,18,45,28,42,31,433,9,49,Lionel Ellison III,51,Fresno State,17,18,49,2016,2016
283,6,5,Summit,20,22,22,54,0,0,54,7,9,8,97,5,6,Jeremy Felton,51,Western Illinois,6,7,25,2010,2010
284,6,3,A-10,20,17,10,26,7,31,57,10,15,34,188,10,18,KC Hankton,51,Saint Louis,6,4,30,2020,2019
285,3,2,Big West,17,20,14,28,6,20,48,5,6,18,125,9,14,Owen Hulland,51,Hawaii,3,13,26,2020,2019
286,12,8,Total,35,18,17,36,1,8,44,14,20,44,476,28,59,Jarod Jahns,51,Texas A&M,9,15,63,2013,2011
287,6,0,Horizon,3,18,7,14,11,27,41,4,4,18,140,2,9,Ryan Janer,51,Detroit Mercy,3,13,5,2009,2009
288,7,1,Sun Belt,4,18,6,17,12,44,61,3,3,27,230,4,12,Corey Johnson,51,Little Rock,7,7,8,2007,2007
289,9,2,Sun Belt,21,19,11,25,8,22,47,5,7,20,190,3,15,T.J. Johnson,51,South Alabama,4,9,24,2014,2014
290,2,1,Big South,20,18,13,20,5,17,37,10,13,11,119,4,5,Willie Kirkland,51,Coastal Carolina,6,6,24,2012,2011
291,37,1,Big East,33,16,2,18,14,58,76,5,11,31,486,6,48,Justin Leemo,51,South Florida,18,21,39,2009,2009
292,5,10,Sun Belt,14,20,20,39,0,0,39,11,14,14,130,15,13,Chris Leggett,51,Troy,5,6,29,2009,2009
293,13,1,Big Sky,16,22,21,39,1,5,44,6,10,21,197,6,23,Isaiah Lewis,51,Northern Arizona,10,22,22,2020,2020
294,1,5,CUSA,41,18,18,41,0,0,41,15,21,31,265,19,46,Gustavo Lino,51,Southern Mississippi,1,5,60,2010,2009
295,8,3,Patriot,12,16,6,17,10,44,61,9,15,42,232,7,22,Brett Marfurt,51,Colgate,4,16,19,2010,2009
296,9,3,Sun Belt,19,18,4,9,14,35,44,1,2,28,257,6,30,Isaiah Maston,51,South Alabama,1,8,25,2014,2014
297,4,3,ACC,7,15,9,25,6,14,39,15,20,15,107,2,10,Christian Matthews,51,Georgia Tech,3,6,9,2017,2017
298,3,10,WCC,45,18,18,37,0,0,37,15,24,44,301,18,60,Okechukwu Mbanugo,51,Santa Clara,6,29,63,2008,2007
299,5,5,Total,15,18,11,35,7,21,56,8,14,27,222,6,20,Christopher Miller,51,Total,4,12,21,2017,2014
300,11,10,Big South,30,20,20,47,0,2,49,11,17,17,222,14,35,Jahleem Montague,51,Longwood,8,22,44,2018,2018
301,15,3,Total,30,22,19,48,3,11,59,4,7,29,256,18,30,Khavon Moore,51,Total,16,17,48,2020,2019
302,5,2,Patriot,20,15,15,29,0,0,29,21,27,12,164,11,21,Constantin Motnii,51,American,1,17,31,2008,2008
303,3,7,A-Sun,17,21,21,31,0,1,32,9,21,30,97,16,14,Brendan Newton,51,Liberty,1,8,33,2020,2019
304,10,0,OVC,16,16,6,8,10,21,29,9,14,38,146,3,27,Charles Newton,51,Tennessee Tech,13,14,19,2011,2010
305,18,2,Southland,21,16,14,45,2,21,66,17,31,34,315,5,45,Dezon Otis,51,Texas-San Antonio,9,38,26,2008,2007
306,4,4,WCC,30,24,24,42,0,0,42,3,9,23,195,17,22,Tristan Parham,51,Santa Clara,1,13,47,2007,2007
307,4,1,A-Sun,2,18,3,5,15,34,39,0,0,28,94,1,6,Tanner Plemmons,51,Stetson,2,6,3,2014,2013
308,17,1,Southern,11,17,11,21,6,27,48,11,15,21,218,7,17,Diego Rivera,51,Mercer,7,10,18,2020,2020
309,4,1,OVC,28,19,19,38,0,0,38,13,26,26,212,16,37,Tarod Sanders,51,Murray State,9,12,44,2008,2008
310,5,14,SWAC,26,17,14,39,3,11,50,14,26,66,312,12,39,TyQuayion Smith,51,Alcorn State,12,17,38,2019,2016
311,1,9,AEC,40,19,19,40,0,0,40,13,26,41,284,17,40,Jakob Stenhede,51,Maryland-Baltimore County,2,9,57,2016,2015
312,8,10,MVC,22,19,19,42,0,0,42,13,24,36,231,18,54,Robin Thompson,51,Missouri State,14,10,40,2017,2015
313,10,36,SWAC,34,22,22,43,0,0,43,7,25,89,499,26,110,David Tillman,51,Arkansas-Pine Bluff,7,36,60,2018,2014
314,7,0,WCC,17,17,3,3,14,28,31,3,5,54,161,7,19,Dustin Triano,51,Gonzaga,4,4,24,2017,2015
315,4,4,Ivy,14,16,8,31,8,19,50,11,25,10,179,12,23,Donovon Wright,51,Cornell,2,5,26,2017,2017
316,10,4,Sun Belt,19,18,16,31,2,6,37,13,19,24,263,3,29,Horace Wyatt Jr.,51,Little Rock,5,15,22,2019,2019
317,12,3,CAA,20,19,12,30,7,34,64,5,10,27,337,12,34,Will Adams,50,Towson,8,21,32,2012,2012
318,9,0,GWC,11,16,14,38,2,9,47,16,24,25,167,5,25,Dewayne Bowden,50,Houston Baptist,5,20,16,2013,2012
319,3,3,Big South,11,17,14,18,3,16,34,13,14,23,103,4,21,Justin Brown,50,North Carolina-Asheville,5,9,15,2018,2017
320,72,2,WAC,34,15,13,27,2,18,45,18,22,25,427,7,35,Chris Cole,50,New Mexico State,22,37,41,2008,2008
321,31,0,Total,33,16,14,35,2,17,52,16,30,42,408,20,53,Richard Connor,50,Savannah State,12,32,53,2012,2011
322,31,1,MVC,24,14,1,13,13,35,48,9,11,27,324,2,38,Ford Cooper Jr.,50,Missouri State,14,21,26,2020,2020
323,1,0,MEAC,9,22,16,25,6,26,51,0,0,16,142,9,11,Derek Crumpton,50,North Carolina A&T,6,6,18,2007,2007
324,41,8,MEAC,29,20,19,48,1,3,51,9,23,43,437,12,44,Clinton Cuffee,50,Howard,29,42,41,2012,2011
325,11,0,MAC,13,18,17,36,1,6,42,13,15,7,109,1,9,Daniel Dzierzawski,50,Toledo,2,17,14,2017,2017
326,0,10,ACC,24,19,19,24,0,0,24,12,19,21,145,11,21,Jesse Edwards,50,Syracuse,4,6,35,2020,2020
327,1,12,AEC,39,21,21,51,0,0,51,8,16,32,400,24,75,Uwem Eshietedoho,50,Maryland-Baltimore County,6,12,63,2008,2007
328,16,1,Southland,14,21,14,34,7,23,57,1,2,36,194,2,16,Austin Falke,50,Stephen F. Austin,7,11,16,2010,2008
329,15,10,GWC,52,19,19,53,0,0,53,12,28,78,550,32,93,Rory Fannon,50,Utah Valley,4,36,84,2012,2010
330,20,2,Patriot,20,18,18,27,0,0,27,14,20,22,170,4,16,Joe Foley,50,Lehigh,7,21,24,2019,2019
331,21,2,Total,14,16,9,23,7,21,44,11,20,47,238,3,17,Keith Fuetsch,50,Nevada,9,20,17,2013,2010
332,15,1,MEAC,22,22,21,52,1,3,55,5,15,18,242,12,23,Jared Grady,50,Delaware State,9,16,34,2009,2009
333,3,3,MAC,24,22,22,33,0,1,34,6,12,27,184,11,30,Owen Hamilton,50,Northern Illinois,7,10,35,2018,2018
334,17,1,Southland,27,20,12,27,8,36,63,2,4,49,425,9,29,Matt Hancock,50,Lamar,2,21,36,2015,2013
335,3,11,Total,63,21,21,35,0,0,35,8,22,41,300,17,54,Usman Haruna,50,Total,4,14,80,2019,2018
336,10,2,AAC,27,20,18,37,2,4,41,8,14,18,205,21,21,Chris Hawkins,50,Memphis,7,10,48,2015,2015
337,13,5,Big South,35,19,19,35,0,2,37,12,29,34,228,17,20,K.J. James,50,High Point,8,15,52,2016,2015
338,21,1,Southland,16,16,9,27,7,30,57,11,19,71,314,12,28,Matthew Jiles,50,New Orleans,15,21,28,2018,2015
339,5,15,MEAC,24,20,13,26,7,22,48,3,7,30,160,7,28,D'Andre Johnson,50,North Carolina A&T,2,10,31,2019,2018
340,28,4,Big Sky,34,16,6,34,10,35,69,8,16,20,351,5,36,Judah Jordan,50,Weber State,23,21,39,2020,2020
341,4,1,Ivy,14,16,0,4,16,39,43,2,2,31,170,1,9,Sean Kane,50,Brown,0,9,15,2009,2008
342,7,11,Horizon,35,21,21,51,0,0,51,8,19,24,311,25,53,Youssoupha Kane,50,Detroit Mercy,9,19,60,2015,2015
343,3,3,Horizon,16,17,15,30,2,15,45,14,20,24,171,9,30,Brandon Kenyon,50,IUPUI,4,8,25,2020,2019
344,30,0,OVC,21,17,3,12,14,48,60,2,2,39,366,0,37,Logan Koch,50,Eastern Illinois,13,17,21,2020,2017
345,5,12,Pac-12,30,18,18,26,0,0,26,14,18,43,178,17,26,Matt Korcheck,50,Arizona,3,7,47,2015,2014
346,8,9,Southland,36,18,15,38,3,9,47,11,16,27,242,10,44,Gatdoar Kueth,50,Northwestern State,4,20,46,2020,2020
347,17,5,Big Sky,22,14,11,21,3,19,40,19,24,41,279,9,43,Montie Leunen,50,Portland State,8,8,31,2017,2015
348,28,0,SWAC,31,15,15,36,0,2,38,20,27,33,402,4,50,Thomas Marshall,50,Southern,14,30,35,2013,2012
349,4,4,MAC,35,16,15,36,1,4,40,17,33,29,176,21,28,Jordan Martin,50,Eastern Michigan,9,8,56,2016,2015
350,8,1,Summit,31,19,19,44,0,0,44,12,25,43,240,20,28,Duol Mayot,50,South Dakota,4,14,51,2016,2015
351,16,2,Total,20,18,16,38,2,4,42,12,31,32,265,16,29,Dashawn McDowell,50,Total,7,18,36,2019,2017
352,25,0,Big South,18,17,5,11,12,36,47,4,8,27,213,3,24,Kyle Moore,50,Winthrop,4,14,21,2007,2007
353,13,0,ACC,14,18,8,15,10,27,42,4,6,37,153,8,8,Matt Morris,50,Clemson,6,9,22,2008,2007
354,0,5,WCC,26,19,19,44,0,0,44,12,17,30,216,19,31,Manny Ochenje,50,Pepperdine,1,11,45,2013,2012
355,4,3,Big West,19,21,21,44,0,0,44,8,11,29,183,7,32,Blair Orr,50,Cal State Northridge,2,10,26,2019,2017
356,3,2,MEAC,24,17,11,20,6,51,71,10,16,34,255,15,50,Giir Ring,50,Coppin State,6,24,39,2020,2019
357,6,17,Patriot,51,18,18,36,0,0,36,14,25,63,374,24,86,David Safstrom,50,Lehigh,7,27,75,2011,2008
358,2,5,OVC,19,20,17,36,3,12,48,7,10,20,127,7,16,Braxton Shaw,50,Eastern Illinois,5,14,26,2020,2019
359,5,1,Total,,17,4,10,13,45,55,3,5,34,,,,Iman Shokouhizadeh,50,Centenary (LA),5,3,19,2008,2007
360,8,1,Southland,42,17,8,20,9,29,49,7,11,32,229,12,21,Aaron Smith,50,Stephen F. Austin,4,9,54,2010,2009
361,0,8,OVC,15,17,17,31,0,0,31,16,23,16,158,9,23,Dontrell Taylor,50,Tennessee State,0,14,24,2008,2008
362,8,41,CAA,70,21,21,48,0,0,48,8,16,47,309,19,68,Andre Walker,50,Hofstra,6,20,89,2017,2015
363,9,10,Big South,25,20,20,33,0,0,33,10,23,20,201,8,26,Jatayveous Watson,50,South Carolina Upstate,6,11,33,2020,2020
364,27,1,Total,28,18,9,21,9,41,62,5,7,35,384,8,28,Mason Wedel,50,Missouri-Kansas City,19,16,36,2015,2013
365,16,8,A-Sun,30,20,17,54,3,12,66,7,15,30,369,31,45,Jonathan Whipple,50,Kennesaw State,16,20,61,2010,2010
366,18,4,Southland,24,19,15,43,4,12,55,8,14,20,235,4,22,Jalen White,50,Texas A&M-Corpus Christi,3,22,28,2020,2020
367,6,4,Total,28,19,19,51,0,0,51,12,22,34,287,21,42,Blake Wilkinson,50,Total,11,16,49,2017,2012
368,11,1,MVC,12,17,16,28,1,14,42,15,17,13,113,3,12,Joseph Yesufu,50,Drake,11,11,15,2020,2020
369,12,1,ACC,13,13,3,12,10,24,36,13,19,17,137,0,11,Antoine Allen,49,Miami (FL),10,14,13,2010,2010
370,2,0,MEAC,13,16,2,6,14,29,35,3,4,21,95,4,12,Daryl Anderson,49,Norfolk State,2,4,17,2020,2020
371,7,0,MVC,16,17,7,17,10,26,43,5,5,9,120,0,7,Aarias Austin,49,Northern Iowa,2,8,16,2016,2016
372,8,2,Big 12,30,19,13,30,6,39,69,5,15,23,194,14,29,Will Baker,49,Texas,5,20,44,2020,2020
373,8,16,Big South,35,17,17,27,0,0,27,15,31,29,263,18,37,Jamon Battle,49,North Carolina-Asheville,10,10,53,2020,2020
374,8,3,MAAC,18,17,4,8,13,44,52,2,2,27,233,2,24,Vangelis Bebis,49,Iona,8,7,20,2015,2015
375,9,1,SEC,4,18,11,23,7,23,46,6,12,16,137,1,15,James Bishop,49,Louisiana State,4,11,5,2020,2020
376,5,1,Big Sky,23,16,12,33,4,21,54,13,21,21,181,5,22,Kyle Carey,49,Northern Colorado,4,12,28,2017,2017
377,4,6,Summit,26,21,21,36,0,0,36,7,18,26,236,22,33,Raphael Carter,49,Oakland,5,9,48,2013,2013
378,43,1,NEC,14,13,10,20,3,10,30,20,23,18,248,3,24,Job Casimir,49,Quinnipiac,11,30,17,2007,2007
379,3,12,NEC,35,19,19,33,0,0,33,11,25,32,251,25,51,Eric Coggins,49,Quinnipiac,2,8,60,2010,2009
380,7,2,Summit,34,16,14,20,2,6,26,15,19,33,192,12,10,Joshua Doss,49,South Dakota,8,9,46,2018,2017
381,16,8,AAC,43,18,6,20,12,30,50,1,2,38,261,14,39,Xavier Dupree,49,Houston,10,18,57,2017,2016
382,3,10,MAC,26,19,19,47,0,3,50,11,20,29,193,14,38,Josh Egner,49,Akron,2,14,40,2012,2011
383,7,1,Big West,11,16,1,8,15,51,59,2,6,53,190,2,25,Dyrbe Enos ,49,Hawaii,6,11,13,2016,2014
384,11,6,Southland,16,20,20,47,0,0,47,9,18,28,185,26,39,Marc Andre Fortin,49,Sam Houston State,4,14,42,2016,2016
385,3,6,Sun Belt,29,18,15,24,3,15,39,10,13,18,150,12,24,Devante Foster,49,Troy,5,12,41,2019,2019
386,5,1,Big Sky,21,19,14,20,5,19,39,6,8,27,179,8,7,Quentin Guliford,49,Montana State,7,4,29,2020,2019
387,3,4,Sun Belt,16,18,15,34,3,7,41,10,16,26,140,8,35,Donaries Hair,49,Middle Tennessee,3,9,24,2007,2007
388,7,2,SWAC,19,17,6,17,11,40,57,4,6,18,173,9,23,Jurmelle Hall,49,Mississippi Valley State,7,10,28,2015,2015
389,69,1,Sun Belt,15,12,8,24,4,25,49,21,31,30,544,2,53,Buddy Harding,49,Little Rock,13,41,17,2007,2007
390,6,0,NEC,12,15,6,15,9,31,46,10,15,30,190,5,28,Shyheim Hicks,49,Long Island University,1,12,17,2019,2018
391,10,13,A-10,50,15,9,32,6,25,57,13,19,65,485,26,68,Matt Hill,49,Massachusetts,19,18,76,2012,2008
392,14,1,MEAC,16,14,9,48,5,17,65,16,22,13,209,6,32,Montrell Horsey,49,Delaware State,8,22,22,2019,2019
393,2,5,Sun Belt,20,19,19,28,0,0,28,11,24,45,185,14,39,Vieux Kande,49,Louisiana,3,11,34,2015,2014
394,13,6,Patriot,18,16,3,9,13,36,45,4,8,14,245,5,18,Drew LaMont,49,American,7,10,23,2018,2018
395,28,2,Big South,23,18,10,20,8,15,35,5,9,30,258,20,15,David Long,49,Coastal Carolina,5,18,43,2008,2007
396,15,4,WAC,30,16,8,20,8,23,43,9,11,16,304,7,26,Carlo Marble,49,Chicago State,4,18,37,2020,2020
397,3,9,Ivy,20,21,21,41,0,0,41,7,12,17,143,7,25,John Marciano,49,Dartmouth,1,11,27,2008,2008
398,4,2,Patriot,20,20,20,25,0,0,25,9,15,27,172,6,30,Frane Markusovic,49,American,2,8,26,2009,2008
399,4,0,Southern,4,15,3,5,12,38,43,7,9,15,98,0,5,Stephen McClellan,49,Chattanooga,2,3,4,2008,2008
400,15,4,Total,35,15,8,27,7,18,45,12,18,54,363,15,62,Jimmy McDonnell,49,Temple,9,22,50,2015,2012
401,3,12,WAC,32,21,21,36,0,0,36,7,11,28,228,13,25,William McNair,49,New Mexico State,2,11,45,2020,2020
402,5,1,OVC,10,16,13,25,3,18,43,14,18,20,112,3,11,Eric Mosley,49,Austin Peay,5,8,13,2010,2010
403,7,6,Big South,24,17,17,36,0,0,36,15,22,31,275,31,31,Troy Pierce,49,Charleston Southern,10,11,55,2011,2011
404,3,23,Total,44,15,15,45,0,0,45,19,25,51,360,23,72,Glen Pierre,49,Total,7,19,67,2017,2014
405,30,1,Southern,39,14,14,26,0,5,31,21,28,81,442,43,69,Will Reigel,49,Davidson,9,14,82,2012,2009
406,7,8,Ind,44,21,19,54,2,11,65,5,11,21,259,23,38,De'Aundray Robinson,49,Cal State Bakersfield,14,17,67,2011,2011
407,11,8,MWC,48,14,10,34,4,24,58,17,30,47,512,28,82,Ryan Singer,49,San Jose State,5,23,76,2018,2015
408,0,9,Patriot,51,19,19,36,0,0,36,11,23,41,353,27,46,Jared Smoot,49,Navy,2,23,78,2013,2012
409,6,6,MWC,23,19,19,35,0,0,35,11,20,31,257,12,53,Bienvenu Songondo,49,Wyoming,2,9,35,2008,2007
410,13,0,MVC,14,16,6,13,10,30,43,7,10,29,192,4,12,Taylor Stafford,49,Evansville,4,3,18,2015,2015
411,4,3,MAC,23,20,20,29,0,0,29,9,19,17,120,15,19,Mading Thok,49,Ball State,1,7,38,2015,2014
412,6,1,OVC,17,19,11,23,8,30,53,3,5,14,164,10,13,Trell Thompson,49,Morehead State,6,11,27,2018,2018
413,45,0,Big East,35,16,7,15,9,24,39,8,11,28,309,1,27,Symir Torrence,49,Marquette,7,20,36,2020,2020
414,3,7,Big Ten,15,16,16,32,0,1,33,17,26,27,164,13,25,Johnathan Uchendu,49,Purdue,2,8,28,2007,2007
415,2,0,MAC,11,17,6,11,11,39,50,4,9,32,135,2,10,Von Washington,49,Western Michigan,5,5,13,2015,2014
416,6,3,MAAC,19,17,11,21,6,14,35,9,18,8,155,4,13,Noah Waterman,49,Niagara,1,11,23,2020,2020
417,11,2,MVC,25,17,15,23,2,6,29,13,19,28,196,6,24,Tom Welch,49,Loyola (IL),4,11,31,2020,2020
418,4,1,AAC,27,16,11,31,5,24,55,12,16,27,211,13,17,Raquan Wilkins,49,East Carolina,7,14,40,2017,2017
419,6,6,Big South,30,18,18,43,0,1,44,12,19,35,255,25,41,Herve Aholode,48,Gardner-Webb,9,9,55,2016,2015
420,2,8,MAAC,30,17,17,35,0,0,35,14,22,55,357,18,94,Carlton Allen,48,Manhattan,7,17,48,2016,2014
421,2,5,MEAC,26,20,20,46,0,0,46,8,15,24,224,17,39,Akeem Anderson,48,Maryland-Eastern Shore,7,17,43,2012,2012
422,24,1,Southern,21,16,14,27,2,13,40,14,19,36,298,7,50,Ta'Vonne Bond,48,Virginia Military Institute,16,24,28,2019,2018
423,3,25,Big East,46,22,22,50,0,0,50,4,10,27,230,13,45,Keith Butler,48,DePaul,3,22,59,2007,2007
424,10,1,A-Sun,17,13,4,15,9,53,68,13,21,21,251,4,35,Jose Cami,48,Campbell,6,18,21,2008,2008
425,12,1,Patriot,13,15,0,3,15,48,51,3,6,41,163,5,11,Grant Carter,48,Army,1,4,18,2008,2007
426,38,2,Big South,39,16,10,25,6,37,62,10,22,33,455,37,96,Jack Castleberry,48,Virginia Military Institute,42,38,76,2007,2007
427,16,2,SWAC,22,15,7,22,8,30,52,10,13,33,277,11,23,Patrick Coleman,48,Southern,4,15,33,2012,2011
428,37,1,SEC,27,12,3,12,9,29,41,15,18,22,317,5,32,Branden Conrad,48,South Carolina,21,17,32,2009,2008
429,1,7,Sun Belt,36,13,13,49,0,4,53,22,36,36,256,10,49,Christian Davis,48,Arkansas State,4,22,46,2017,2016
430,18,1,Southland,10,15,10,28,5,17,45,13,20,35,170,4,14,Preston Davis,48,Stephen F. Austin,4,13,14,2009,2008
431,12,3,WCC,18,18,10,21,8,31,52,4,5,26,171,6,28,Raul Delgado,48,Brigham Young,9,8,24,2013,2013
432,16,1,Ivy,15,15,12,31,3,13,44,15,23,30,155,5,26,Eze Dike,48,Yale,3,21,20,2020,2019
433,5,0,Sun Belt,9,14,0,2,14,44,46,6,7,28,212,1,20,Dusty Driggs,48,New Orleans,4,5,10,2007,2007
434,2,0,AAC,14,18,14,33,4,18,51,8,13,20,125,3,12,Morris Dunnigan,48,Houston,4,4,17,2017,2017
435,8,2,OVC,21,19,13,28,6,14,42,4,9,20,157,10,24,Joan Duran,48,Tennessee Tech,8,9,31,2018,2018
436,5,21,OVC,22,18,18,36,0,0,36,12,25,24,240,24,26,J.P. Felder,48,Austin Peay,2,16,46,2007,2007
437,12,2,Sun Belt,10,17,13,35,4,18,53,10,11,26,219,7,17,Reggie Fondren,48,Little Rock,8,8,17,2012,2012
438,9,0,MVC,16,17,11,28,6,12,40,8,17,12,139,14,10,Stephan Gabriel,48,Bradley,3,12,30,2020,2020
439,4,8,A-Sun,19,19,19,34,0,0,34,10,16,20,212,22,32,Zadrian Gibson,48,Kennesaw State,7,14,41,2010,2010
440,4,0,WAC,10,16,1,2,15,44,46,1,2,18,94,1,4,Nick Grieves,48,San Jose State,2,4,11,2013,2012
441,5,13,SWAC,31,22,22,45,0,1,46,4,21,30,350,24,34,Jamar Harris,48,Arkansas-Pine Bluff,2,20,55,2012,2012
442,18,3,AAC,15,15,10,24,5,16,40,13,24,26,225,3,32,Zach Harvey,48,Cincinnati,9,14,18,2020,2020
443,3,30,MEAC,35,19,19,39,0,0,39,10,16,49,355,26,64,Gilroy Hemsley,48,Morgan State,7,16,61,2008,2007
444,4,4,MEAC,20,21,21,38,0,0,38,6,15,26,147,12,39,Cristian Henry,48,North Carolina A&T,3,14,32,2011,2011
445,12,0,MAAC,22,17,11,18,6,29,47,8,9,16,200,18,11,Jon Hogga,48,Saint Peter's,4,11,40,2008,2008
446,14,0,ACC,8,17,10,22,7,23,45,7,11,9,174,1,17,Chase Hunter,48,Clemson,7,12,9,2020,2020
447,8,0,SWAC,16,13,3,8,10,39,47,12,13,19,245,6,27,Marcus Johnson,48,Mississippi Valley State,8,10,22,2014,2013
448,19,4,A-Sun,26,15,3,18,12,28,46,6,15,25,242,8,28,Shea Jones,48,Jacksonville,6,19,34,2016,2015
449,1,13,CAA,19,20,20,47,0,0,47,8,15,33,161,16,26,Trey Kalina,48,North Carolina-Wilmington,1,12,35,2019,2018
450,31,3,MEAC,18,18,17,39,1,13,52,11,13,29,318,6,42,Brian Kelley,48,Norfolk State,12,29,24,2016,2016
451,3,3,Ivy,14,18,17,33,1,6,39,11,21,31,144,6,20,Isaiah Kelly,48,Yale,5,12,20,2020,2019
452,3,5,Big South,19,21,21,36,0,0,36,6,11,23,151,21,17,Bisi Latunde-Addey,48,Coastal Carolina,5,11,40,2013,2012
453,9,3,AEC,13,19,13,19,6,17,36,4,9,33,193,15,17,Corry Long,48,Stony Brook,13,11,28,2019,2018
454,0,2,OVC,11,19,16,34,3,5,39,7,8,20,137,10,25,Mike Louder,48,Jacksonville State,1,4,21,2014,2013
455,32,0,MWC,22,18,12,30,6,47,77,6,6,28,346,5,23,Danny Mahoney,48,San Jose State,8,30,27,2016,2015
456,10,6,A-Sun,22,16,16,26,0,0,26,16,21,28,226,28,55,Xavier Mayo,48,NJIT,6,9,50,2020,2020
457,6,0,Ivy,16,16,2,6,14,42,48,2,2,34,141,8,10,Kuba Mijakowski,48,Pennsylvania,2,7,24,2019,2017
458,37,0,MAC,22,14,5,16,9,30,46,11,12,19,342,2,33,Zach Miller,48,Northern Illinois,11,29,24,2012,2012
459,6,9,A-Sun,25,17,16,37,1,4,41,13,27,27,253,13,43,Eric Moeller,48,Florida Gulf Coast,4,25,38,2015,2015
460,2,13,SEC,36,19,19,32,0,0,32,10,17,44,259,20,39,John Odo,48,Louisiana State,4,12,56,2015,2014
461,14,1,Southland,42,14,12,26,2,6,32,18,22,16,189,11,12,Chris Orlina,48,McNeese State,4,14,53,2020,2020
462,39,1,OVC,10,19,18,40,1,1,41,9,16,21,238,4,21,C.J. Reese,48,Southeast Missouri State,5,30,14,2014,2014
463,6,11,MAAC,48,17,17,33,0,0,33,14,33,45,321,31,55,Kris Rolle,48,Saint Peter's,5,10,79,2015,2014
464,21,10,Patriot,44,21,21,47,0,1,48,6,17,72,572,24,76,Travis Rollo,48,Army,9,21,68,2016,2013
465,7,0,Total,30,15,5,8,10,38,46,8,11,54,382,11,48,Matt Rosenwinkel,48,Northern Kentucky,9,7,41,2017,2014
466,6,5,Southland,17,23,23,44,0,0,44,2,11,19,211,13,22,Donovon Ross,48,Southeastern Louisiana,3,7,30,2012,2012
467,27,0,AEC,14,18,10,18,8,30,48,4,7,27,336,4,32,Jude Roybal,48,New Hampshire,8,31,18,2007,2007
468,5,13,Total,19,18,18,34,0,0,34,12,24,34,219,22,38,Zisis Sarikopoulos,48,Total,3,17,41,2010,2008
469,24,0,MEAC,47,19,19,55,0,15,70,10,21,45,455,25,37,Marc Seylan,48,Maryland-Eastern Shore,12,22,72,2017,2016
470,13,8,AEC,59,19,19,48,0,0,48,10,16,68,370,14,52,Ryan Shields,48,Vermont,6,19,73,2009,2007
471,10,1,NEC,16,20,18,47,2,14,61,6,16,39,279,11,29,Erick Smith,48,Bryant,6,18,27,2013,2011
472,2,6,Big South,36,24,24,35,0,0,35,0,10,24,185,10,22,Khydarius Smith,48,South Carolina Upstate,8,7,46,2020,2020
473,1,0,WCC,7,14,3,4,11,33,37,9,12,44,136,5,4,Andrew Sorenson,48,Gonzaga,7,4,12,2009,2007
474,13,4,Big 12,21,19,14,24,5,21,45,5,10,55,277,7,67,Marek Soucek,48,Oklahoma State,3,16,28,2015,2012
475,24,0,Big South,21,17,14,32,3,19,51,11,16,22,194,8,22,Gavin Stephenson,48,Virginia Military Institute,16,19,29,2013,2013
476,7,11,MWC,52,16,14,41,2,6,47,14,22,26,210,26,29,Luke Tauscher,48,Texas Christian,4,8,78,2008,2008
477,11,0,Sun Belt,9,16,6,20,10,34,54,6,11,28,218,4,25,Jameson Tipping,48,Western Kentucky,5,9,13,2010,2010
478,6,8,GWC,53,22,22,45,0,1,46,4,19,59,401,34,115,Quincy Ukaigwe,48,Chicago State,15,28,87,2013,2011
479,3,7,AEC,27,20,20,46,0,0,46,8,21,34,274,14,58,Will Wise,48,Maryland-Baltimore County,3,18,41,2013,2012
480,10,1,Horizon,28,11,11,40,0,1,41,26,41,52,298,22,52,Christian Wolf,48,Milwaukee,3,14,50,2013,2011
481,10,0,A-10,5,15,5,13,10,26,39,8,12,56,153,3,13,Malcolm Wynter,48,Davidson,3,5,8,2020,2017
482,3,24,CUSA,44,20,20,48,0,0,48,7,17,32,319,33,72,Orlando Allen,47,Marshall,3,24,77,2011,2011
483,44,9,ACC,37,17,14,34,3,6,40,10,25,56,350,12,48,Zavier Anderson,47,Clemson,26,46,49,2011,2008
484,1,0,Total,19,15,12,27,3,15,42,14,16,64,278,13,35,Joey Asbury,47,Oakland,7,8,32,2014,2011
485,22,0,SWAC,29,12,12,32,0,1,33,23,41,22,162,10,14,Shaq Athie,47,Grambling,5,17,39,2019,2019
486,5,10,SWAC,37,22,22,34,0,0,34,3,15,36,316,21,36,Corrie Austin,47,Grambling,5,20,58,2009,2007
487,36,0,MEAC,23,17,11,32,6,28,60,7,13,47,443,4,36,Yannick Braimbridge,47,Howard,10,43,27,2010,2009
488,3,5,SWAC,19,18,18,51,0,0,51,11,34,10,177,20,18,Tim Brown,47,Southern,1,19,39,2009,2009
489,6,2,AEC,22,16,12,32,4,17,49,11,18,22,218,14,30,Brett Burrier,47,Maryland-Baltimore County,4,10,36,2009,2009
490,5,6,Big Sky,26,16,16,36,0,1,37,15,21,25,164,16,31,Gus Chase,47,Montana,4,13,42,2007,2007
491,10,0,Big South,16,15,10,27,5,17,44,12,14,26,149,2,18,Devin Cooper,47,Radford,1,15,18,2018,2016
492,4,6,Big South,38,19,18,41,1,11,52,8,12,32,233,28,38,Stephen Edoka,47,North Carolina-Asheville,10,20,66,2020,2019
493,20,1,Big West,31,13,11,32,2,12,44,19,23,29,253,6,30,Korri Ennis,47,UC-Riverside,16,16,37,2007,2007
494,23,0,WCC,22,13,7,29,6,17,46,15,25,19,262,3,32,Andre Ferguson,47,Portland,5,23,25,2017,2017
495,6,0,Ivy,8,17,4,6,13,35,41,0,1,42,127,5,5,Bobby Foley,47,Princeton,2,7,13,2011,2008
496,14,3,Sun Belt,34,17,14,32,3,19,51,10,11,11,222,11,23,Facundo Giorgi,47,Florida International,5,23,45,2007,2007
497,7,1,MAC,15,20,17,29,3,11,40,4,10,24,106,8,7,Charles Harris,47,Western Michigan,3,6,23,2015,2013
498,5,0,Southland,15,19,10,18,9,24,42,0,4,15,151,9,10,Joe Harris,47,Central Arkansas,3,6,24,2012,2012
499,29,8,OVC,44,14,12,28,2,2,30,17,26,47,266,21,56,Matt Hasse,47,Austin Peay,8,17,65,2013,2011
500,3,4,Southland,10,15,15,37,0,0,37,17,20,23,153,13,46,Zach Iyeyemi,47,Houston Baptist,2,22,23,2020,2020
501,12,0,OVC,5,17,9,21,8,18,39,5,8,21,142,1,24,Cordell James,47,Morehead State,7,23,6,2013,2013
502,19,3,Summit,20,17,10,21,7,19,40,6,13,25,329,9,43,Matt Johns,47,South Dakota,10,14,29,2020,2019
503,9,0,Sun Belt,13,19,14,32,5,21,53,4,8,16,189,5,27,Martavis Key,47,Florida International,3,7,18,2010,2010
504,9,1,Patriot,20,14,9,29,5,26,55,14,23,39,280,12,27,Ian Langendoerfer,47,Loyola (MD),2,23,32,2018,2017
505,6,0,A-10,13,15,3,10,12,30,40,5,6,45,139,2,13,Edwin Lashley,47,Saint Joseph's,3,8,15,2009,2007
506,18,0,Sun Belt,18,18,13,28,5,13,41,6,9,23,281,3,21,Daijon Macklien,47,Arkansas State,6,24,21,2015,2015
507,4,10,WCC,41,21,21,37,0,0,37,5,17,42,386,24,61,Jan Maehlen,47,Pepperdine,4,18,65,2013,2011
508,3,2,Big Ten,29,18,18,31,0,1,32,11,18,27,149,12,20,Julius Marble,47,Michigan State,1,7,41,2020,2020
509,4,4,MAAC,9,17,17,46,0,1,47,13,17,10,205,23,29,Ola Matti,47,Canisius,8,8,32,2007,2007
510,6,12,MEAC,80,16,16,46,0,0,46,15,26,54,674,36,171,Brandon Moore,47,Maryland-Eastern Shore,10,32,116,2008,2007
511,13,0,Big 12,19,13,13,23,0,7,30,21,34,24,144,4,23,Clarence Nadolny,47,Texas Tech,5,11,23,2020,2020
512,15,2,NEC,18,17,9,22,8,19,41,5,9,12,165,11,22,Desjuan Newton,47,Robert Morris,6,7,29,2014,2014
513,7,14,Southland,29,20,20,40,0,2,42,7,12,18,180,13,16,Corey Nickerson,47,Lamar,6,14,42,2020,2020
514,2,1,Big Ten,6,17,5,9,12,56,65,1,2,42,206,2,21,Adrien Nunez,47,Michigan,3,7,8,2020,2019
515,1,10,MAC,28,20,20,33,0,1,34,7,17,47,188,17,29,Innocent Nwoko,47,Central Michigan,7,10,45,2019,2018
516,6,2,Ivy,5,23,23,35,0,0,35,1,3,10,130,11,24,Adam Powers,47,Dartmouth,5,5,16,2008,2008
517,2,7,NEC,29,20,20,46,0,0,46,7,15,21,192,22,24,James St. Robert,47,St. Francis (NY),2,19,51,2007,2007
518,8,0,SWAC,22,15,11,24,4,16,40,13,24,20,191,15,11,Kshun Stokes,47,Arkansas-Pine Bluff,5,10,37,2020,2020
519,31,0,A-10,10,12,9,29,3,16,45,20,28,10,166,4,24,Daryl Traynham,47,Massachusetts,16,21,14,2011,2011
520,48,4,MAAC,51,17,15,65,2,5,70,11,29,57,743,38,86,Jamal Turner,47,Fairfield,17,43,89,2010,2009
521,11,0,Total,32,15,5,15,10,42,57,7,9,40,241,9,25,Parker U'u,47,Total,10,24,41,2016,2013
522,7,34,Big South,35,21,21,46,0,0,46,5,15,22,237,8,36,C.J. Walker,47,North Carolina-Asheville,1,24,43,2007,2007
523,6,1,Big West,9,14,4,14,10,24,38,9,9,20,139,10,12,Justin Wertner,47,UC-Irvine,4,3,19,2018,2018
524,3,5,WAC,36,18,17,35,1,6,41,10,22,26,252,12,34,Eugene Witherspoon,47,Chicago State,5,21,48,2019,2019
525,12,1,Ind,18,18,10,31,8,30,61,3,6,29,254,5,21,Walter Woghiren,47,Chicago State,9,22,23,2007,2007
526,4,22,Total,25,18,18,35,0,0,35,10,22,39,230,25,44,Keion Alexander,46,Total,7,15,50,2018,2017
527,11,1,Summit,25,13,6,15,7,23,38,13,19,25,271,5,54,Mael Amenvedzi,46,Western Illinois,2,22,30,2011,2011
528,5,1,MAAC,22,15,15,36,0,0,36,16,38,21,210,17,31,Barney Anderson,46,Rider,1,9,39,2007,2007
529,11,1,Big Sky,16,18,9,23,9,19,42,1,2,23,220,11,18,McKay Anderson,46,Southern Utah,5,10,27,2014,2014
530,5,1,CAA,9,15,4,7,11,35,42,5,7,18,114,2,15,Jeremy Basnight,46,North Carolina-Wilmington,2,7,11,2010,2010
531,3,3,OVC,16,15,15,27,0,4,31,16,22,15,88,13,14,Colton Blevins,46,Tennessee Tech,1,5,29,2017,2017
532,5,0,Horizon,35,12,12,32,0,0,32,22,30,29,353,26,51,Chris Booth,46,Youngstown State,9,13,61,2007,2007
533,5,0,Southern,20,18,17,37,1,10,47,9,16,24,215,12,16,Jonathan Bryant II,46,Chattanooga,4,12,32,2018,2018
534,24,2,Big Sky,20,14,11,29,3,9,38,15,20,28,291,13,23,Jeff Christensen,46,Eastern Washington,4,20,33,2009,2009
535,6,0,SWAC,26,19,19,46,0,0,46,8,14,33,212,22,34,Demetrice Clopton,46,Jackson State,2,14,48,2019,2017
536,3,2,MAAC,15,17,6,13,11,46,59,1,1,21,210,1,10,Nick Colletta,46,Marist,5,6,16,2015,2014
537,1,4,MVC,21,20,20,38,0,0,38,6,16,28,208,17,32,Christian Cornelius,46,Southern Illinois,5,16,38,2009,2008
538,18,0,Big West,22,13,10,30,3,17,47,17,28,42,274,6,20,Michael Creppy,46,UC-Riverside,7,24,28,2008,2007
539,25,0,Big East,16,16,7,17,9,25,42,5,8,30,293,7,23,Timmy Crowell,46,Cincinnati,11,18,23,2007,2007
540,12,0,Ivy,16,16,6,8,10,38,46,4,5,31,148,7,15,Jackson Forbes,46,Princeton,3,9,23,2017,2015
541,6,0,AAC,7,17,8,12,9,27,39,3,6,21,116,1,12,Charles Foster,46,East Carolina,1,13,8,2016,2016
542,7,0,Total,18,18,14,31,4,10,41,6,12,38,266,15,21,Mike Fox,46,Nebraska,4,9,33,2012,2010
543,5,2,GWC,24,21,21,34,0,2,36,4,13,23,232,19,36,Garrett Frick,46,NJIT,6,11,43,2012,2012
544,2,8,MAAC,35,20,20,39,0,0,39,6,13,34,207,14,43,Kenny Grant,46,Rider,4,17,49,2016,2015
545,5,5,MWC,48,15,15,42,0,0,42,16,29,27,247,27,46,Christian Gray,46,Fresno State,7,9,75,2019,2019
546,4,1,AAC,10,17,11,19,6,22,41,6,8,22,169,7,16,Jayden Hardaway,46,Memphis,5,12,17,2020,2020
547,16,1,A-Sun,7,16,10,39,6,33,72,8,9,16,197,2,11,Jalen Harper,46,Florida Gulf Coast,9,18,9,2020,2020
548,7,11,SWAC,30,22,22,40,0,0,40,2,6,40,253,10,49,Oliver Jefferson,46,Jackson State,1,23,40,2011,2009
549,26,0,Ind,40,17,10,23,7,37,60,5,10,26,343,8,14,Jason Jensen,46,Texas-Rio Grande Valley,8,15,48,2009,2009
550,11,3,MAC,34,15,13,38,2,12,50,14,32,29,214,12,34,Robert Johnson,46,Kent State,7,16,46,2012,2011
551,6,10,Total,21,20,17,31,3,15,46,3,6,24,197,16,36,Lucas Jones,46,Total,7,8,37,2009,2007
552,7,0,Patriot,18,19,14,33,5,13,46,3,3,15,154,3,9,Dave Kasanganay,46,Navy,9,8,21,2020,2020
553,5,3,ACC,28,18,14,25,4,19,44,6,9,33,176,7,27,Shaun Kirk,46,North Carolina State,5,13,35,2018,2016
554,36,0,WCC,20,18,14,29,4,12,41,6,12,17,256,8,27,Simon Krajcovic,46,Loyola Marymount,13,30,28,2015,2015
555,2,7,Pac-12,32,21,21,32,0,0,32,4,15,22,182,20,31,Volodymyr Markovetskyy,46,Washington State,0,9,52,2020,2020
556,14,0,WAC,8,14,4,6,10,25,31,8,9,23,188,1,13,J.J. Marshall,46,Louisiana Tech,3,7,9,2008,2007
557,7,5,MAAC,13,17,16,39,1,7,46,11,14,17,173,14,25,Robert Martina,46,Manhattan,2,8,27,2011,2011
558,7,0,A-Sun,15,15,7,11,8,34,45,8,12,27,200,9,13,Ridas Pulkauninkas,46,Mercer,5,8,24,2010,2010
559,2,9,Big Sky,48,18,17,33,1,1,34,9,15,32,266,36,27,Zachary Reynolds,46,Northern Arizona,3,10,84,2015,2014
560,13,3,Ind,24,19,17,29,2,7,36,6,14,20,185,9,32,Alex Robinson,46,Texas-Rio Grande Valley,11,16,33,2007,2007
561,6,1,WAC,17,14,1,1,13,33,34,5,5,22,120,0,12,Micah Robinson,46,California Baptist,4,2,17,2020,2019
562,32,0,NEC,23,12,9,35,3,13,48,19,37,60,327,14,39,Steve Robinson,46,Quinnipiac,18,21,37,2010,2007
563,47,6,A-10,37,15,6,33,9,36,69,7,20,29,427,3,51,Kyle Rose,46,Fordham,30,31,40,2020,2020
564,12,0,MAAC,11,16,5,9,11,26,35,3,5,20,143,2,21,C.J. Seaforth,46,Iona,2,13,13,2018,2018
565,2,13,WCC,14,14,14,29,0,0,29,18,28,28,177,10,34,Blake Sholberg,46,Saint Mary's (CA),6,16,24,2007,2007
566,5,0,Big West,20,14,6,15,8,32,47,10,19,21,174,12,24,Temjae Singleton,46,Cal State Fullerton,0,10,32,2015,2015
567,6,0,MEAC,12,16,8,14,8,30,44,6,7,18,151,2,12,Fred Slater,46,South Carolina State,4,4,14,2019,2019
568,2,4,NEC,16,18,16,29,2,4,33,8,15,34,185,14,21,Randy Spaid,46,Saint Francis (PA),4,7,30,2009,2007
569,3,0,Southern,7,14,1,4,13,27,31,5,6,39,79,1,9,Matt Steelman,46,Wofford,1,3,8,2012,2009
570,2,2,OVC,38,18,11,25,7,27,52,3,8,26,210,7,33,Jaylin Stewart,46,Southeast Missouri State,5,7,45,2016,2016
571,4,1,SWAC,13,14,2,13,12,51,64,6,7,10,152,5,11,Dominique Street,46,Jackson State,3,5,18,2015,2015
572,16,0,Big Ten,18,15,7,16,8,22,38,8,13,27,250,10,29,Errek Suhr,46,Indiana,8,12,28,2007,2007
573,1,0,Big 12,12,15,0,3,15,50,53,1,2,50,150,4,7,Jarrett Sutton,46,Missouri,5,1,16,2012,2009
574,17,1,CUSA,8,14,1,5,13,32,37,5,6,19,140,4,18,Christopher Szalay,46,Rice,1,11,12,2008,2007
575,16,2,Big Ten,24,22,22,31,0,2,33,2,3,29,271,14,34,Ivan Tolic,46,Northwestern,7,15,38,2007,2007
576,20,0,A-10,15,16,9,23,7,26,49,7,12,21,124,4,12,P.J. Torres,46,Duquesne,4,14,19,2013,2012
577,26,0,Big Ten,33,17,14,32,3,9,41,9,23,34,241,12,15,Johnny Trueblood,46,Nebraska,11,12,45,2019,2016
578,37,1,Big Sky,16,13,3,13,10,34,47,10,10,29,264,8,25,Casey Trujeque,46,Montana State,9,21,24,2011,2011
579,4,5,AAC,29,21,21,44,0,0,44,4,13,27,220,17,28,Emmanuel Ugboh,46,Tulsa,2,21,46,2020,2020
580,13,0,ACC,20,13,12,27,1,13,40,19,25,49,319,4,36,Trent VanHorn,46,Wake Forest,9,15,24,2017,2014
581,14,5,NEC,43,20,20,43,0,1,44,6,15,49,253,8,48,Daniel Wallace,46,Saint Francis (PA),5,21,51,2018,2015
582,1,4,Summit,28,19,19,35,0,0,35,8,13,41,201,13,48,Anthony Williams,46,IUPUI,4,6,41,2011,2009
583,7,2,ACC,18,18,11,25,7,19,44,3,5,38,217,17,41,Matt Zitani,46,Florida State,5,9,35,2008,2007
584,2,4,Total,31,9,9,23,0,0,23,27,32,37,163,10,24,Armend Ademi,45,Purdue-Fort Wayne,1,9,41,2008,2007
585,0,14,Big 12,18,19,19,34,0,0,34,7,14,28,150,15,31,Orlando Allen,45,Oklahoma,1,9,33,2010,2009
586,6,2,CUSA,18,17,16,47,1,9,56,10,19,25,190,12,42,Terrance Beasley,45,Tulane,4,15,30,2010,2010
587,10,5,A-Sun,48,14,14,42,0,1,43,17,28,62,284,21,25,Marcus Blake,45,Florida Gulf Coast,6,18,69,2015,2012
588,10,0,AEC,4,17,11,22,6,25,47,5,8,29,174,11,16,Ryan Burnett,45,Stony Brook,0,8,15,2015,2014
589,7,1,Total,13,19,17,40,2,14,54,5,8,14,136,5,16,Jordan Campbell,45,Total,2,14,18,2020,2019
590,22,3,CUSA,21,14,8,22,6,17,39,11,24,48,318,16,50,Jamie Chapman,45,Southern Mississippi,15,20,37,2015,2013
591,3,9,NEC,44,18,18,27,0,1,28,9,24,45,221,13,38,Ganlandou Cisse,45,Long Island University,5,11,57,2020,2016
592,17,2,Big South,18,17,15,28,2,9,37,9,16,24,228,6,25,Ricky Clemons,45,Campbell,3,5,24,2020,2019
593,4,3,Pac-10,27,18,18,35,0,0,35,9,19,15,215,15,27,Kasey Cunningham,45,Southern California,8,17,42,2010,2008
594,3,0,AEC,14,17,12,35,5,19,54,6,14,16,149,13,9,Tre Cunningham,45,Stony Brook,3,12,27,2007,2007
595,0,13,MAC,14,15,15,28,0,0,28,15,26,16,151,18,31,Mike Dabney,45,Bowling Green State,4,10,32,2011,2011
596,8,13,Big West,61,20,20,38,0,0,38,5,8,33,369,34,61,Ryan Darling,45,Cal Poly,7,14,95,2010,2009
597,4,3,ACC,13,17,14,26,3,7,33,8,18,34,85,10,4,Paul Debnam,45,Virginia Tech,5,7,23,2011,2008
598,4,2,Southland,14,15,5,20,10,36,56,5,7,22,169,8,15,Zac Downing,45,Stephen F. Austin,4,8,22,2011,2011
599,7,0,Big East,21,13,2,4,11,30,34,8,10,32,201,2,20,Dre Evans,45,Providence,3,9,23,2011,2011
600,27,1,Sun Belt,10,15,6,12,9,34,46,6,7,15,162,2,22,Kadavion Evans,45,Louisiana,7,9,12,2017,2017
601,8,0,Big 12,13,15,13,24,2,13,37,13,23,15,160,9,14,Patrick Fields,45,Baylor,2,19,22,2007,2007
602,10,3,Ind,27,19,18,38,1,11,49,6,10,20,212,22,37,Marvin Fitzgerald,45,North Carolina Central,8,15,49,2011,2011
603,20,5,MEAC,31,17,13,40,4,39,79,7,15,31,483,12,38,Treyvon Francis,45,Savannah State,30,35,43,2016,2015
604,6,1,MAAC,8,18,15,24,3,15,39,6,14,29,197,6,31,Gob Gabriel,45,Monmouth,4,15,14,2020,2020
605,8,1,Total,21,16,6,17,10,44,61,3,8,48,193,15,11,Stojan Gjuroski,45,Louisiana Tech,3,12,36,2014,2012
606,4,1,SEC,24,18,15,27,3,13,40,6,8,24,192,15,17,Yavuz Gultekin,45,Texas A&M,4,6,39,2020,2020
607,8,1,NEC,10,13,13,19,0,2,21,19,25,20,130,7,26,Nino Hernandez,45,Bryant,2,14,17,2019,2019
608,10,0,OVC,9,17,15,31,2,16,47,9,18,25,183,9,11,Deveyon Hunter,45,Eastern Kentucky,2,12,18,2009,2009
609,14,5,Sun Belt,29,20,20,43,0,0,43,5,19,22,247,18,37,Elijah Ifejeh,45,Louisiana-Monroe,6,31,47,2020,2020
610,12,5,Ind,26,17,17,40,0,0,40,11,15,24,256,27,39,Beno Jaekel,45,Longwood,4,27,53,2008,2008
611,3,0,Big 12,5,14,9,18,5,11,29,12,20,17,94,3,11,Ryan Kelley,45,Colorado,3,8,8,2009,2009
612,8,0,Summit,16,15,4,7,11,25,32,4,4,22,167,5,20,Ryan Krueger,45,South Dakota State,6,0,21,2019,2019
613,16,5,Sun Belt,36,14,14,31,0,0,31,17,28,25,271,23,57,Brad Larson,45,Florida International,6,19,59,2007,2007
614,6,12,MAC,49,18,18,37,0,0,37,9,20,47,340,31,86,Marquiez Lawrence,45,Kent State,8,24,80,2015,2014
615,4,4,A-10,25,18,18,33,0,0,33,9,14,24,161,4,28,Marcus Littles,45,George Washington,1,20,29,2019,2019
616,3,4,Horizon,27,16,16,38,0,0,38,13,22,22,175,24,32,Sam Mauldin,45,Milwaukee,3,18,51,2007,2007
617,22,3,MEAC,35,18,18,34,0,2,36,9,15,44,252,18,23,Marius McAllister,45,North Carolina Central,11,15,53,2018,2015
618,8,0,Big South,8,17,7,13,10,36,49,1,2,11,116,5,12,Alquan Mendenhall,45,High Point,6,3,13,2009,2009
619,12,10,Southland,55,16,16,50,0,0,50,13,46,43,420,23,63,Chris Paige,45,Nicholls State,9,41,78,2009,2008
620,15,0,CUSA,28,19,14,28,5,22,50,2,6,8,174,16,22,Terrence Roderick,45,Alabama-Birmingham,8,10,44,2009,2009
621,8,1,MWC,14,20,16,27,4,13,40,1,2,13,144,14,24,Anthony Smith,45,Nevada-Las Vegas,6,8,28,2018,2018
622,12,9,SWAC,42,15,15,46,0,0,46,15,37,42,348,30,77,Chris Smith,45,Arkansas-Pine Bluff,10,31,72,2020,2019
623,51,2,MAC,25,20,19,41,1,12,53,4,12,62,350,6,47,Matty Smith,45,Central Michigan,12,30,31,2019,2017
624,15,0,Big Sky,15,12,3,19,9,35,54,12,17,17,194,7,29,Sean Smith,45,Portland State,6,10,22,2007,2007
625,20,0,Summit,5,16,11,38,5,15,53,8,12,18,129,1,5,Aireus Stephenson,45,South Dakota State,4,10,6,2011,2011
626,3,4,Big Sky,24,18,12,27,6,24,51,3,7,24,113,9,19,Mason Stuteville,45,Sacramento State,1,7,33,2016,2015
627,1,8,Pac-12,39,16,16,24,0,0,24,13,20,25,223,19,28,Lahat Thioune,45,Utah,4,11,58,2020,2020
628,4,8,CUSA,34,19,19,30,0,1,31,7,20,38,251,15,29,Stacey Thomas,45,Louisiana Tech,2,11,49,2020,2019
629,2,12,Pac-12,31,17,17,34,0,1,35,11,29,29,226,17,38,D.J. Thorpe,45,University of California,5,15,48,2020,2020
630,27,2,Big 12,12,15,10,39,5,10,49,10,15,18,266,3,28,Kevin Wagner,45,Texas Tech,7,19,15,2012,2012
631,1,4,Big Sky,24,17,17,31,0,1,32,11,19,21,116,13,16,Matt Washington,45,Weber State,5,7,37,2010,2010
632,19,0,Horizon,13,10,6,12,4,21,33,21,27,30,195,6,18,Ryan Werch,45,Green Bay,8,14,19,2007,2007
633,22,1,OVC,21,14,6,24,8,39,63,9,13,22,251,3,33,Connor Wheeler,45,Southern Illinois-Edwardsville,9,12,24,2016,2016
634,9,3,WAC,13,18,18,26,0,9,35,9,13,24,228,12,8,Kalil Whitehead,45,Chicago State,6,12,25,2020,2020
635,10,12,Ivy,19,15,11,25,4,16,41,11,20,33,306,10,39,Longi Yiljep,45,Brown,5,20,29,2015,2012
636,1,2,SWAC,17,17,17,36,0,0,36,10,19,9,156,13,23,Trevor Banks,44,Arkansas-Pine Bluff,3,8,30,2019,2019
637,6,2,MAAC,11,10,6,14,4,16,30,20,26,20,127,7,17,Andrea Bernardi,44,Marist,8,20,18,2018,2018
638,12,0,Big West,8,17,17,36,0,1,37,10,21,15,130,8,9,Chris Brew,44,UC-Santa Barbara,9,8,16,2010,2010
639,2,7,Big West,35,18,16,35,2,5,40,6,13,25,200,18,31,T.J. Burke,44,UC-Riverside,2,13,53,2013,2012
640,2,0,A-Sun,17,15,9,11,6,29,40,8,11,19,152,8,15,Kaleb Coleman,44,Lipscomb,3,15,25,2020,2020
641,25,0,Southland,26,12,2,8,10,25,33,10,17,30,267,3,46,Michael Corchiani,44,Southeastern Louisiana,16,21,29,2017,2017
642,5,12,SWAC,29,16,16,35,0,0,35,12,34,24,213,19,53,Isaiah Cotton,44,Alabama A&M,5,20,48,2015,2015
643,20,5,Ind,13,18,15,29,3,16,45,5,6,25,225,9,22,Maurice County,44,New Orleans,11,12,22,2013,2013
644,11,0,Southland,17,13,4,10,9,28,38,9,18,27,238,9,21,Kennon Dvorak,44,Texas A&M-Corpus Christi,6,11,26,2013,2012
645,14,0,Big West,15,11,7,11,4,29,40,18,19,42,206,3,31,Niko Filipovich,44,Hawaii,9,19,18,2016,2015
646,2,2,MEAC,30,20,20,40,0,0,40,4,20,32,216,20,44,Webster Filmore,44,North Carolina A&T,7,16,50,2020,2019
647,19,0,Ivy,8,13,1,6,12,36,42,6,6,17,196,0,18,Spencer Freedman,44,Harvard,2,19,8,2020,2019
648,3,0,CAA,7,14,12,20,2,5,25,14,21,29,66,4,9,Jamison Glover,44,William & Mary,2,4,11,2018,2015
649,16,2,ACC,18,15,12,26,3,24,50,11,14,23,200,6,17,Brycen Goodine,44,Syracuse,11,17,24,2020,2020
650,7,0,Big West,29,16,6,11,10,31,42,2,2,20,211,9,20,Roger Guardia,44,Cal State Fullerton,7,12,38,2011,2011
651,6,1,Southland,5,12,6,20,6,17,37,14,25,4,99,3,9,Ameer Jackson,44,Sam Houston State,0,6,8,2016,2016
652,2,10,Total,29,17,17,50,0,0,50,10,31,14,172,29,21,Sidiki Johnson,44,Total,6,13,58,2013,2012
653,6,0,Big West,20,15,8,17,7,25,42,7,18,17,219,10,25,Steve Jurich,44,Cal State Fullerton,3,12,30,2011,2011
654,13,0,Big East,28,17,8,16,9,35,51,1,5,22,267,3,22,Keonte Kennedy,44,Xavier,6,11,31,2019,2019
655,5,0,MEAC,6,15,5,12,10,26,38,4,9,36,151,5,14,Danijel Krleski,44,Maryland-Eastern Shore,5,9,11,2008,2007
656,13,1,Ivy,14,19,13,21,6,27,48,0,0,26,247,12,23,James Lambert,44,Harvard,6,20,26,2007,2007
657,34,5,Horizon,59,17,17,42,0,3,45,10,14,29,499,14,60,Alonde Legrand,44,Detroit Mercy,18,34,73,2020,2020
658,11,4,Patriot,23,20,20,36,0,1,37,4,7,33,177,11,26,Sam Lindgren,44,Colgate,7,8,34,2019,2016
659,5,0,Big East,6,11,3,7,8,19,26,14,18,23,120,6,8,Carl Marshall,44,Seton Hall,3,4,12,2007,2007
660,34,0,Total,23,15,8,27,7,22,49,7,10,64,289,3,22,Nick Martineau,44,Brigham Young,10,16,26,2012,2008
661,2,11,MEAC,25,19,19,46,0,1,47,6,17,49,284,16,54,Raymoan McAfee,44,Bethune-Cookman,2,16,41,2012,2011
662,2,1,OVC,21,17,17,32,0,0,32,10,13,26,143,10,27,Arthur McMillan,44,Morehead State,2,12,31,2011,2011
663,8,0,Southern,12,15,1,5,14,52,57,0,3,53,222,3,15,Jason McMillan,44,Western Carolina,6,11,15,2020,2017
664,5,10,Patriot,28,19,19,35,0,0,35,6,19,51,231,20,32,John Miller,44,Army,6,12,48,2019,2016
665,10,2,MAAC,18,19,16,30,3,4,34,3,15,34,198,21,25,Nyandigsi Moikubo,44,Iona,0,12,39,2013,2012
666,12,0,Horizon,17,16,13,26,3,11,37,9,13,19,197,8,23,Madison Monroe,44,Oakland,6,16,25,2020,2020
667,4,6,GWC,12,18,17,35,1,8,43,7,13,10,119,13,22,Sean Montgomery,44,Chicago State,1,16,25,2011,2011
668,5,3,Summit,30,17,17,35,0,2,37,10,16,27,219,15,42,Tim Morton,44,Oral Roberts,2,10,45,2011,2011
669,3,1,Sun Belt,7,15,1,4,14,47,51,0,0,40,87,2,8,Scott Muirhead,44,Texas-Arlington,0,5,9,2019,2017
670,4,10,WAC,30,20,20,37,0,0,37,4,14,52,360,32,66,Shawn Oliverson,44,Louisiana Tech,3,16,62,2010,2009
671,8,0,Big West,9,17,15,27,2,15,42,8,8,22,165,5,4,Davon Potts,44,Cal State Northridge,2,6,14,2012,2012
672,7,0,Pac-12,32,14,4,16,10,35,51,6,10,26,309,18,22,DJ Rodman,44,Washington State,5,8,50,2020,2020
673,15,1,Southland,22,18,16,35,2,8,43,6,11,19,175,14,25,Ray Sansom,44,Lamar,7,13,36,2007,2007
674,10,5,AEC,27,19,19,43,0,1,44,6,14,23,247,21,41,Chris Seaborn,44,Maryland-Baltimore County,4,22,48,2007,2007
675,2,1,MAC,18,19,18,38,1,7,45,5,8,25,183,7,34,Kenny Stewart,44,Eastern Michigan,7,12,25,2011,2011
676,6,0,Summit,16,12,7,21,5,19,40,15,20,16,208,11,26,Alton Tanner,44,Missouri-Kansas City,6,12,27,2013,2013
677,38,0,WCC,22,9,6,13,3,28,41,23,29,28,261,2,29,David Thompson,44,Santa Clara,4,26,24,2020,2020
678,3,10,Pac-12,38,14,14,26,0,0,26,16,42,43,236,20,39,Victor Uyaelunmo,44,Southern California,5,14,58,2019,2018
679,10,5,Southland,32,13,10,35,3,18,53,15,22,26,215,11,26,Zach Williams,44,Stephen F. Austin,10,11,43,2009,2009
680,23,2,NEC,21,14,12,27,2,8,35,14,22,30,233,3,29,Corey Wright,44,Long Island University,9,29,24,2010,2010
681,10,3,WCC,11,18,16,28,2,11,39,6,14,23,197,1,27,Lazar Zivanovic,44,Loyola Marymount,5,20,12,2020,2020
682,4,2,Big Sky,15,15,12,19,3,6,25,10,15,25,142,6,32,Ajang Aguek,43,Northern Arizona,2,6,21,2020,2020
683,3,11,CUSA,40,14,14,27,0,0,27,15,16,56,349,34,76,Reid Aube,43,Charlotte,5,14,74,2017,2014
684,5,0,Ind,9,16,5,19,11,42,61,0,0,25,162,4,19,Mike Bennett,43,Savannah State,5,9,13,2007,2007
685,5,2,Total,5,19,19,37,0,0,37,5,7,31,117,7,27,Admir Besovic,43,Total,2,10,12,2020,2018
686,14,1,Big West,13,16,7,8,9,21,29,2,2,19,156,6,8,Trevor Bing,43,UC-Santa Barbara,8,11,19,2007,2007
687,7,0,Sun Belt,30,12,10,19,2,12,31,17,23,23,221,7,15,Percy Blade,43,Western Kentucky,7,23,37,2013,2013
688,6,0,Big West,22,16,12,23,4,19,42,7,10,30,261,17,26,JC Butler,43,UC-Irvine,9,4,39,2019,2019
689,8,3,OVC,22,17,11,28,6,9,37,3,5,14,136,10,7,Michael Chavers,43,Eastern Illinois,4,4,32,2018,2018
690,5,1,Big Sky,9,15,7,29,8,32,61,5,8,18,139,3,21,Danny Cheek,43,Northern Arizona,7,12,12,2012,2012
691,2,4,OVC,22,16,15,42,1,5,47,10,23,48,245,17,49,Andreas Coleman,43,Morehead State,3,16,39,2009,2008
692,13,0,Sun Belt,27,15,7,12,8,34,46,5,10,34,245,10,25,Zach Cottrell,43,Appalachian State,7,8,37,2018,2017
693,3,1,Total,14,14,11,19,3,12,31,12,28,27,159,9,27,Gilles Dekoninck,43,Total,5,13,23,2019,2018
694,6,12,Total,35,17,17,36,0,9,45,9,18,35,175,16,29,Ibrahim Famouke Doumbia,43,Total,3,12,51,2020,2018
695,19,1,Big Sky,13,14,9,22,5,26,48,10,16,24,208,9,31,Kenton Eskridge,43,Southern Utah,10,15,22,2019,2019
696,2,1,GWC,13,14,6,11,8,21,32,7,10,8,99,4,8,Mitch Farrell,43,NJIT,6,7,17,2013,2013
697,7,6,SWAC,19,16,14,40,2,16,56,9,19,34,263,11,26,Royce Hamilton,43,Alabama A&M,11,14,30,2010,2009
698,10,1,SWAC,5,15,4,5,11,39,44,2,3,22,180,3,19,Eddie Hardy,43,Alabama A&M,1,10,8,2012,2012
699,4,0,OVC,14,14,7,11,7,16,27,8,16,34,153,2,15,Brandon Harriford,43,Austin Peay,5,17,16,2008,2007
700,13,6,Total,34,15,14,24,1,3,27,12,21,48,290,19,40,Christian Harrison,43,Total,18,14,53,2019,2015
701,6,0,SEC,9,15,4,4,11,19,23,2,4,18,111,1,13,Eric Hester,43,Florida,6,3,10,2017,2017
702,7,0,SWAC,17,14,9,26,5,23,49,10,18,24,215,22,24,Jared Howard,43,Alabama State,3,12,39,2007,2007
703,21,0,Big Sky,21,13,3,10,10,25,35,7,10,25,290,4,24,Rhett Humphrey,43,Eastern Washington,11,24,25,2007,2007
704,5,0,ACC,9,15,4,5,11,33,38,2,2,13,74,2,14,Nathanael Jack,43,Florida State,1,5,11,2020,2020
705,7,0,Horizon,6,12,10,22,2,7,29,17,21,11,106,12,15,Lance James,43,Cleveland State,4,9,18,2010,2010
706,11,0,Patriot,23,18,13,30,5,13,43,2,2,49,309,6,21,Luke Johnson,43,Loyola (MD),4,8,29,2020,2018
707,1,4,MAC,20,19,19,30,0,0,30,5,10,35,150,17,32,Bud Jones,43,Eastern Michigan,1,11,37,2019,2018
708,19,1,Big West,16,16,8,13,8,21,34,3,7,26,201,4,29,Jordan Knox,43,Cal State Fullerton,5,8,20,2013,2012
709,6,1,SWAC,8,13,2,7,11,29,36,6,12,27,123,4,18,Xairius Larry,43,Grambling,7,6,12,2017,2017
710,7,8,Big West,28,18,16,28,2,10,38,5,15,31,164,13,21,Coby Leavitt,43,Cal Poly,6,16,41,2008,2007
711,16,0,SWAC,45,19,18,49,1,9,58,4,16,50,369,6,28,Divonte Lumpkin,43,Texas Southern,22,19,51,2020,2018
712,5,1,A-10,6,16,14,24,2,7,31,9,13,16,112,14,10,Jarren McAllister,43,Virginia Commonwealth,5,8,20,2020,2020
713,4,1,Southland,6,15,2,4,13,34,38,0,0,22,136,1,19,Chris Mejia,43,Southeastern Louisiana,1,2,7,2017,2017
714,8,2,Summit,54,20,20,71,0,3,74,3,9,63,433,35,41,Arsenio Mims,43,Western Illinois,14,12,89,2011,2008
715,8,18,MEAC,35,18,18,36,0,0,36,7,21,30,273,14,48,Orin O'Bryant,43,Hampton,6,20,49,2012,2012
716,5,1,SWAC,9,13,7,28,6,29,57,11,23,25,234,9,25,Malachy Onwudiegwu,43,Alcorn State,3,18,18,2016,2016
717,3,1,Southland,16,15,5,16,10,36,52,3,5,22,159,4,19,Zach Padgett,43,Central Arkansas,4,11,20,2013,2013
718,9,2,A-10,10,14,3,8,11,53,61,4,6,32,153,5,24,Sean Phaler,43,Charlotte,0,9,15,2008,2007
719,0,4,MAAC,38,14,14,34,0,1,35,15,31,66,265,27,47,Steven Priestley,43,Siena,6,13,65,2011,2008
720,16,0,Big Sky,13,15,10,19,5,14,33,8,13,28,128,2,9,Johnatan Reyes,43,Northern Colorado,4,15,15,2019,2018
721,12,8,Sun Belt,32,15,12,28,3,12,40,10,23,24,204,15,32,Atakan Sahinkaya,43,Troy,12,15,47,2020,2019
722,7,0,WAC,5,16,14,25,2,4,29,9,15,10,117,4,7,C.J. Scott,43,Louisiana Tech,1,13,9,2011,2011
723,4,12,Big East,30,20,20,35,0,0,35,3,11,36,339,27,64,Greg Sequele,43,DePaul,8,14,57,2015,2014
724,7,3,WAC,15,13,12,30,1,2,32,16,33,26,170,18,23,Justonn Smith,43,San Jose State,4,13,33,2007,2007
725,13,1,CUSA,21,15,11,29,4,14,43,9,16,24,196,18,21,Pearson Smith,43,Texas-El Paso,7,9,39,2008,2007
726,25,1,Pac-12,20,16,13,32,3,14,46,8,9,21,175,4,10,Kyle Sturdivant,43,Southern California,5,22,24,2020,2020
727,4,0,MEAC,5,14,3,14,11,29,43,4,6,10,121,3,7,Kai Tease,43,Howard,2,10,8,2018,2018
728,1,1,Southland,10,17,14,24,3,8,32,6,8,4,80,12,7,Jason Thompson,43,Houston Baptist,0,5,22,2020,2020
729,8,10,Horizon,32,17,17,43,0,1,44,9,13,33,215,13,31,Hrvoje Vucic,43,Valparaiso,2,15,45,2012,2011
730,10,3,MEAC,34,17,16,48,1,19,67,7,11,20,201,18,13,Omar Akram,42,Maryland-Eastern Shore,9,13,52,2008,2008
731,29,1,MEAC,17,12,5,21,7,24,45,11,14,39,291,10,44,Dwayne Banks,42,South Carolina State,9,41,27,2019,2018
732,3,9,MEAC,30,19,18,36,1,2,38,3,5,24,144,11,21,Michael Barber,42,Howard,7,9,41,2020,2020
733,6,0,Sun Belt,8,14,2,3,12,27,30,2,3,16,184,1,23,Joey Barnitz,42,New Orleans,1,14,9,2007,2007
734,4,1,Southland,19,18,18,35,0,0,35,6,19,28,208,19,44,Freddy Bitondo,42,Sam Houston State,1,9,38,2018,2018
735,3,5,Total,20,13,7,22,6,25,47,10,17,27,179,7,31,Gavin Bizeau,42,Total,2,9,27,2020,2019
736,5,1,Big South,27,19,16,27,3,6,33,1,7,33,139,11,14,Matt Boswell,42,High Point,2,7,38,2008,2007
737,5,0,Big Sky,11,13,3,13,10,34,47,6,8,18,133,9,12,Tyler Brimhall,42,Idaho,6,7,20,2017,2017
738,10,1,Ind,19,16,16,26,0,1,27,10,21,26,186,12,29,Ryan Buck,42,Texas-Rio Grande Valley,4,9,31,2008,2007
739,0,2,Pac-12,11,14,14,28,0,0,28,14,20,19,101,15,21,Michael Chandler,42,Oregon,2,11,26,2015,2015
740,44,1,MAC,26,11,6,21,5,13,34,15,16,15,341,6,17,Antonio Chatman,42,Ohio,13,29,32,2007,2007
741,5,3,Big 12,20,14,14,32,0,0,32,14,29,23,234,17,38,Paul Cooper,42,Texas Tech,4,16,37,2011,2011
742,14,6,WCC,17,15,6,13,9,17,30,3,4,17,108,2,26,Andrew Ferguson,42,San Diego,3,9,19,2019,2019
743,14,0,Ivy,6,9,7,17,2,16,33,22,26,18,174,4,23,Mike Fleming,42,Dartmouth,5,12,10,2014,2014
744,5,14,OVC,30,16,16,38,0,1,39,10,32,28,241,27,66,Marcus Fuggins,42,Morehead State,11,22,57,2015,2015
745,30,1,Big 12,22,16,14,39,2,15,54,8,15,33,314,10,27,Kirby Gardner,42,Oklahoma State,14,19,32,2013,2013
746,2,9,A-Sun,23,19,19,47,0,1,48,4,7,22,235,13,42,Clint Graham,42,Gardner-Webb,2,14,36,2007,2007
747,0,3,SWAC,17,18,14,30,4,12,42,2,10,9,112,3,12,Grady Green,42,Prairie View,1,11,20,2010,2010
748,3,8,MAC,31,18,17,31,1,5,36,5,10,33,180,13,12,Isaiah Green,42,Eastern Michigan,8,6,44,2019,2018
749,12,1,Sun Belt,32,19,19,43,0,1,44,4,6,24,250,15,30,Donovan Gregory,42,Appalachian State,11,9,47,2020,2020
750,4,3,CAA,11,16,15,28,1,10,38,9,14,17,123,9,29,Trey Grundy,42,North Carolina-Wilmington,5,9,20,2016,2016
751,5,18,SEC,39,17,17,31,0,0,31,8,20,32,235,19,38,Ethan Henderson,42,Arkansas,7,5,58,2020,2019
752,1,7,Southland,20,14,14,22,0,3,25,14,29,25,137,6,26,Terrance Hubby,42,Lamar,9,8,26,2017,2016
753,7,5,Southland,14,14,5,14,9,22,36,5,6,18,157,6,14,Jock Hughes,42,Stephen F. Austin,1,10,20,2019,2019
754,5,4,Total,25,15,13,25,2,13,38,10,14,51,266,18,41,Bryce Jackson,42,Total,2,19,43,2018,2015
755,9,11,Sun Belt,50,14,14,26,0,0,26,14,28,45,372,18,49,LaMarvon Jackson,42,Little Rock,5,20,68,2009,2008
756,6,0,WCC,5,14,1,4,13,39,43,1,2,26,110,3,16,Colby Leifson,42,Brigham Young,2,6,8,2017,2017
757,10,0,Ivy,23,15,7,28,8,30,58,4,6,21,230,8,26,Tellef Lundevall,42,Brown,9,7,31,2012,2012
758,14,1,SWAC,18,13,6,17,7,17,34,9,14,24,223,3,16,Giovanni Mack,42,Texas Southern,6,8,21,2015,2015
759,5,6,Total,28,18,18,40,0,0,40,6,11,40,208,18,26,Matt Maden,42,Gardner-Webb,4,20,46,2010,2007
760,41,0,Southland,21,8,5,25,3,7,32,23,36,44,330,5,51,Shane Mahoney,42,Lamar,12,32,26,2009,2007
761,11,0,Southland,13,14,10,23,4,16,39,10,25,22,205,4,24,Lewis McDaniel,42,Central Arkansas,3,25,17,2020,2020
762,4,0,NEC,34,16,14,27,2,4,31,8,21,22,161,16,15,Shawn Montague,42,Sacred Heart,5,11,50,2017,2017
763,18,0,Pac-12,17,13,0,0,13,28,28,3,4,21,207,1,19,Daine Muller,42,Oregon State,3,9,18,2017,2017
764,0,13,A-Sun,35,14,14,34,0,0,34,14,24,29,201,20,49,Kevin Ndahiro,42,Stetson,2,18,55,2017,2016
765,4,31,MVC,57,19,18,44,1,7,51,3,9,28,333,32,55,Abdou Ndiaye,42,Illinois State,13,15,89,2020,2020
766,19,2,Big 12,25,14,7,27,7,31,58,7,12,30,212,8,22,Shaun Neal-Williams,42,Kansas State,8,15,33,2019,2019
767,9,4,Patriot,27,13,11,16,2,5,21,14,20,43,219,17,31,Alex Orchowski,42,Lafayette,4,13,44,2010,2009
768,8,0,SWAC,11,13,4,15,9,27,42,7,10,28,175,3,7,Isiah Patterson,42,Grambling,4,10,14,2015,2014
769,19,0,SWAC,9,10,7,20,3,8,28,19,26,11,202,6,15,Jerry Perry,42,Texas Southern,6,16,15,2018,2018
770,8,29,Total,46,17,13,34,4,23,57,4,5,42,281,10,19,Mat Piotrowski,42,Total,5,12,56,2015,2012
771,3,0,SEC,7,16,16,38,0,0,38,10,15,16,117,8,25,Uros Plavsic,42,Tennessee,3,9,15,2020,2020
772,3,5,Southland,30,20,20,44,0,4,48,2,7,28,296,18,56,Jordan Pope-Didier,42,Texas A&M-Corpus Christi,7,18,48,2012,2012
773,18,0,CAA,26,15,9,21,6,26,47,6,15,26,348,8,38,Chris Prothro,42,Delaware,4,19,34,2007,2007
774,13,0,WCC,22,16,10,26,6,24,50,4,8,25,199,5,21,Brandon Rohe,42,Santa Clara,11,11,27,2007,2007
775,9,1,Ivy,11,14,6,14,8,23,37,6,8,20,140,1,17,Luka Sakota,42,Harvard,1,11,12,2020,2020
776,2,4,Ind,11,13,13,24,0,0,24,16,23,14,66,14,13,Andrew Smith,42,Texas-Rio Grande Valley,0,3,25,2009,2009
777,9,0,Southland,15,17,15,42,2,14,56,6,11,27,256,14,26,Caleb Starks,42,Northwestern State,5,22,29,2018,2018
778,6,0,Horizon,6,14,10,24,4,15,39,10,12,15,115,4,23,Sammy Sutter,42,Illinois-Chicago,3,10,10,2012,2012
779,3,0,MAC,17,17,17,34,0,1,35,8,10,26,128,4,27,Dylan Swingle,42,Bowling Green State,3,7,21,2020,2020
780,5,0,Ivy,7,14,6,11,8,28,39,6,10,36,115,3,16,Daniel Trepanier,42,Columbia,4,12,10,2009,2007
781,35,1,ACC,34,12,8,18,4,26,44,14,17,41,268,2,8,Howard Washington,42,Syracuse,14,18,36,2020,2018
782,17,2,Big South,16,15,10,26,5,18,44,7,16,29,175,3,14,Jabbar Washington,42,Charleston Southern,6,10,19,2016,2015
783,11,6,CUSA,28,20,20,39,0,1,40,2,5,9,157,11,27,JC Washington,42,Charlotte,3,13,39,2017,2017
784,42,1,Big South,15,14,9,39,5,25,64,9,20,31,445,9,41,Jalen Williams,42,High Point,7,29,24,2017,2017
785,3,0,Big East,12,15,8,15,7,26,41,5,6,16,105,1,4,Jalen Windham,42,Creighton,5,8,13,2020,2020
786,5,1,OVC,12,13,1,4,12,29,33,4,5,7,117,3,10,Johnny Woodard,42,Tennessee State,1,8,15,2016,2016
787,3,1,MAC,33,19,19,31,0,0,31,3,16,63,223,25,55,Adetunji Adedipe,41,Ohio,3,14,58,2011,2009
788,12,0,Big Sky,5,14,7,14,7,18,32,6,9,18,184,1,15,Nico Aguirre,41,Idaho State,6,17,6,2020,2020
789,1,2,CUSA,16,17,16,28,1,4,32,6,9,28,110,9,22,James Ametepe,41,Florida International,5,9,25,2020,2019
790,11,0,CUSA,24,13,4,13,9,30,43,6,9,16,101,2,5,Xaiver Armstead,41,Louisiana Tech,6,5,26,2020,2020
791,40,1,Ivy,21,16,13,34,3,11,45,6,8,20,271,2,23,Tony Bagtas,41,Pennsylvania,13,25,23,2014,2014
792,9,4,Total,50,18,18,44,0,1,45,5,15,52,292,26,31,James Bento,41,Mercer,6,8,76,2016,2014
793,3,2,MVC,11,16,14,24,2,11,35,7,7,15,88,6,9,James Betz,41,Northern Iowa,1,6,17,2020,2020
794,13,0,Ivy,27,13,13,34,0,3,37,15,32,38,253,19,24,Josh Biber,41,Brown,4,11,46,2014,2011
795,5,0,Horizon,12,15,13,31,2,5,36,9,11,8,116,5,7,Kevin Bond,41,Illinois-Chicago,6,11,17,2007,2007
796,4,1,Sun Belt,6,10,1,3,9,24,27,12,15,9,63,2,7,Kinley Branch,41,Arkansas State,3,2,8,2011,2011
797,8,1,Ivy,23,13,6,14,7,23,37,8,12,49,271,3,22,Matt Brown,41,Harvard,8,11,26,2015,2011
798,4,1,AAC,29,13,12,33,1,8,41,14,26,36,257,19,24,Rod Brown,41,Wichita State,7,10,48,2019,2019
799,11,1,Horizon,14,15,4,15,11,36,51,0,2,30,262,7,28,Matt Bush,41,Illinois-Chicago,2,18,21,2012,2011
800,6,6,Southland,27,14,11,17,3,11,28,10,17,21,136,7,26,Corbin Byford,41,Oral Roberts,4,13,34,2014,2013
801,1,7,Total,15,14,14,35,0,0,35,13,26,48,172,13,22,Mitchell Carter,41,Total,3,16,28,2011,2007
802,2,6,ACC,27,14,9,28,5,23,51,8,11,30,180,7,26,Jin Soo Choi,41,Maryland,8,14,34,2010,2009
803,5,1,CAA,19,16,16,39,0,0,39,9,15,12,122,8,13,Corey Cofield,41,William & Mary,4,17,27,2007,2007
804,9,1,Horizon,21,16,14,24,2,15,39,7,13,26,188,13,34,Tristan Crawford,41,Cleveland State,12,5,34,2007,2007
805,4,5,Big South,25,17,17,40,0,1,41,7,11,24,221,14,32,Victor Dorsey,41,Longwood,4,13,39,2015,2015
806,3,19,Southland,32,16,12,38,4,19,57,5,13,23,232,16,35,Chukuka Emili,41,Houston Baptist,5,13,48,2018,2018
807,21,1,Ivy,26,18,18,25,0,4,29,5,8,67,279,3,39,Desmond Fleming,41,Cornell,7,12,29,2017,2014
808,15,0,Ivy,9,16,9,14,7,19,33,2,3,22,269,6,24,Michael Fleming,41,Dartmouth,4,19,15,2016,2016
809,44,0,MVC,16,12,9,29,3,20,49,14,21,28,419,10,36,Kourtney Goff,41,Southern Illinois,23,32,26,2012,2012
810,12,1,Big South,33,15,11,31,4,24,55,7,15,24,199,14,16,Mysta Goodloe,41,South Carolina Upstate,3,19,47,2020,2020
811,13,13,Total,53,19,19,39,0,0,39,3,11,54,405,24,68,DouDou Gueye,41,Total,10,20,77,2017,2015
812,25,1,Summit,19,16,13,27,3,17,44,6,6,14,214,1,12,Reggie Guyton,41,Oral Roberts,7,13,20,2009,2009
813,4,1,Big Sky,7,15,5,8,10,27,35,1,2,21,148,5,14,Keith Haymon,41,Northern Arizona,1,9,12,2020,2020
814,3,7,Southland,26,18,16,49,2,7,56,3,8,28,231,15,42,Austin Henry,41,Incarnate Word,3,5,41,2015,2015
815,23,2,Sun Belt,14,13,13,30,0,2,32,15,27,29,210,4,21,Jaylen Hinton,41,Georgia State,8,4,18,2014,2014
816,3,0,A-Sun,11,15,8,12,7,27,39,4,6,27,92,5,5,Andrew House,41,Belmont,6,8,16,2008,2007
817,15,1,MAC,26,14,12,32,2,8,40,11,25,23,217,7,31,DJ Houston,41,Western Michigan,18,11,33,2019,2019
818,20,0,A-Sun,11,11,6,8,5,7,15,14,16,7,152,1,16,Logan Irwin,41,Stetson,2,13,12,2013,2013
819,13,0,CUSA,7,15,8,18,7,47,65,4,8,28,232,12,21,Cedric Jackson,41,Florida Atlantic,8,3,19,2019,2019
820,5,11,OVC,23,12,12,28,0,0,28,17,31,39,144,9,21,Tomas Janusauskas,41,Austin Peay,2,12,32,2008,2007
821,12,1,GWC,21,15,9,21,6,29,50,5,8,22,236,2,22,Marques Jones,41,NJIT,8,26,23,2012,2012
822,3,1,Big 12,17,16,10,21,6,13,34,3,8,44,103,2,11,Jordan Juenemann,41,Kansas,1,7,19,2012,2009
823,4,4,A-10,26,14,14,28,0,0,28,13,18,43,210,17,30,Adam Knollmeyer,41,Saint Louis,4,22,43,2008,2007
824,3,2,A-Sun,10,14,5,9,9,31,40,4,5,21,156,0,12,Ricky Krainiak,41,Campbell,5,8,10,2010,2010
825,14,0,Big East,6,14,12,29,2,22,51,11,14,22,179,8,18,Johnnie Lacy,41,Providence,7,9,14,2010,2010
826,7,12,MAC,44,19,19,44,0,0,44,3,11,38,289,22,51,Cameron Madlock,41,Total,5,10,66,2011,2008
827,11,0,NEC,23,16,7,23,9,47,70,0,2,31,237,11,17,Naim Miller,41,Mount St. Mary's,5,12,34,2020,2020
828,13,1,Big Ten,20,11,9,19,2,3,22,17,21,72,273,12,23,Aaron Moesch,41,Wisconsin,7,9,32,2018,2015
829,7,1,NEC,12,15,7,17,8,33,50,3,8,11,145,4,11,Larry Moreno,41,St. Francis (NY),3,7,16,2020,2020
830,13,0,Summit,17,13,10,26,3,13,39,12,21,54,154,11,15,Fred Newell,41,North Dakota State,11,9,28,2014,2011
831,1,6,Patriot,16,16,16,27,0,0,27,9,15,25,155,11,15,Alex Newsome,41,Navy,2,13,27,2010,2010
832,10,1,Patriot,14,15,12,27,3,12,39,8,11,20,167,6,30,Greg Page,41,Lehigh,6,12,20,2007,2007
833,13,2,AEC,26,18,14,34,4,16,50,1,5,16,195,8,15,Isaiah Powell,41,Vermont,4,12,34,2020,2020
834,9,3,Pac-10,20,14,14,33,0,0,33,13,28,33,190,17,40,Peter Prowitt,41,Stanford,2,11,37,2008,2007
835,7,3,Horizon,29,12,7,24,5,23,47,12,18,25,228,9,26,Jeron Rogers,41,Cleveland State,4,11,38,2016,2016
836,4,7,Big East,20,18,18,27,0,0,27,5,12,21,150,16,28,Frank Russell,41,Rutgers,1,2,36,2007,2007
837,5,5,OVC,28,18,18,39,0,0,39,5,7,24,139,19,26,Minfeke Sanoe,41,Tennessee-Martin,1,17,47,2019,2019
838,15,9,Ivy,29,17,17,56,0,0,56,7,14,48,297,31,34,Jon Schmidt,41,Brown,4,14,60,2015,2012
839,8,0,MAC,28,15,14,22,1,9,31,10,16,31,244,13,16,T.J. Smith,41,Toledo,6,10,41,2020,2020
840,5,7,Summit,23,18,18,27,0,2,29,5,10,27,177,8,31,Chris Snyder,41,Western Illinois,4,9,31,2018,2017
841,12,2,Total,24,16,16,35,0,0,35,9,17,23,214,24,25,Elijah Staley,41,Total,4,16,48,2018,2016
842,8,2,Horizon,29,11,9,37,2,8,45,17,23,28,200,17,25,Hassan Thomas,41,Illinois-Chicago,7,11,46,2017,2016
843,5,6,Big East,29,17,14,28,3,8,36,4,6,30,214,9,16,Lorenzo Thompson,41,DePaul,8,7,38,2007,2007
844,46,0,Total,19,14,9,23,5,14,37,8,8,31,301,5,30,Ben Voogd,41,Total,16,28,24,2009,2007
845,1,0,MAC,10,15,14,26,1,6,32,10,16,8,86,11,8,Jere Vucica,41,Miami (OH),1,3,21,2016,2016
846,16,1,Big West,13,14,3,5,11,35,40,2,2,35,210,1,11,Sam Walters,41,UC-Santa Barbara,4,13,14,2018,2016
847,4,0,Big Sky,11,18,18,38,0,0,38,5,7,19,221,18,39,Aaron Wilson,41,Sacramento State,5,10,29,2009,2009
848,3,1,OVC,25,17,12,22,5,17,39,2,2,5,110,5,14,Steve Wooten Jr.,41,Tennessee-Martin,8,5,30,2020,2020
849,2,1,MEAC,22,13,13,30,0,0,30,15,21,34,203,14,47,Joseph Wright,41,South Carolina State,8,18,36,2011,2010
850,94,7,NEC,59,17,17,56,0,0,56,7,13,70,833,19,133,Steve Zazuri,41,Sacred Heart,36,73,78,2012,2009
851,11,4,Big Sky,15,14,5,8,9,26,34,4,5,16,135,8,16,Neal Zumwalt,41,Eastern Washington,3,7,23,2007,2007
852,1,18,Total,41,11,11,24,0,0,24,18,34,18,204,24,30,Emmanuel Adeife,40,Total,2,7,65,2009,2008
853,3,2,WCC,16,12,9,14,3,8,22,13,18,21,157,12,24,Ryan Andrus,40,Brigham Young,4,5,28,2015,2015
854,8,13,SWAC,49,13,13,44,0,1,45,14,34,46,382,25,66,Norris Arnold,40,Alabama A&M,21,33,74,2008,2007
855,2,3,Big South,11,15,11,22,4,11,33,6,14,16,128,7,15,Stephen Baird,40,Liberty,4,7,18,2012,2012
856,4,3,WAC,16,16,16,29,0,0,29,8,13,12,146,11,27,Illiwa Baldwin,40,Nevada,2,10,27,2011,2011
857,4,0,SEC,17,13,7,18,6,16,34,8,12,29,155,10,14,TeMarcus Blanton,40,South Carolina,8,7,27,2017,2016
858,30,0,NEC,17,13,10,29,3,10,39,11,15,32,221,6,25,Justin Brickman,40,Bryant,11,24,23,2017,2014
859,38,0,MEAC,21,12,10,42,2,22,64,14,30,57,387,4,49,Isaac Brown,40,Florida A&M,26,36,25,2012,2010
860,2,12,Total,32,16,16,33,0,0,33,8,17,38,339,23,71,Denny Burguillos,40,Georgia State,8,13,55,2014,2013
861,19,4,Patriot,24,14,8,26,6,22,48,6,8,25,242,8,13,Isaiah Burnett,40,Navy,10,21,32,2019,2019
862,8,0,MEAC,6,15,13,32,2,10,42,8,13,10,,0,12,Jermonte Bush,40,Florida A&M,7,14,6,2008,2008
863,6,0,Big 12,16,16,14,32,2,17,49,6,12,16,172,10,23,Maurice Calloo,40,Oklahoma State,1,11,26,2019,2019
864,3,3,Big West,21,9,4,14,5,12,26,17,23,29,130,12,30,Lin Chang,40,Cal State Long Beach,4,11,33,2011,2010
865,5,1,Summit,21,15,10,26,5,21,47,5,7,28,177,10,21,Marko Coudreau,40,North Dakota,3,12,31,2020,2019
866,21,4,Sun Belt,21,11,2,22,9,29,51,9,15,24,267,10,31,Dejan Cvoro,40,Western Kentucky,8,20,31,2009,2009
867,17,0,MAAC,9,13,4,13,9,37,50,5,6,23,288,7,37,Georges Darwiche,40,Siena,4,21,16,2020,2019
868,22,1,Big Sky,22,14,7,20,7,32,52,5,6,19,246,1,25,James Davis,40,Northern Colorado,6,15,23,2013,2013
869,2,1,MEAC,4,13,3,5,10,48,53,4,4,24,142,2,7,Chris Dubose,40,Savannah State,2,3,6,2019,2018
870,3,0,WCC,14,13,9,23,4,9,32,10,17,22,163,9,15,Jake Ehlers,40,Portland,2,10,23,2013,2013
871,19,0,OVC,28,15,9,22,6,17,39,4,5,29,191,3,10,Richard Feagin,40,Morehead State,3,14,31,2019,2018
872,6,2,Patriot,24,15,5,19,10,25,44,0,0,26,220,4,27,Bobby Fenske,40,Navy,2,10,28,2007,2007
873,2,0,A-10,5,12,3,7,9,35,42,7,8,13,93,6,6,Chris Fitzgerald,40,George Washington,3,3,11,2011,2011
874,2,3,Big Sky,17,16,14,30,2,5,35,6,14,23,177,13,31,Finn Fleute,40,Montana State,4,11,30,2020,2020
875,27,0,OVC,25,15,11,26,4,18,44,6,14,23,309,3,43,Fred Garmon,40,Austin Peay,18,24,28,2014,2014
876,2,1,Summit,17,18,18,38,0,0,38,4,11,18,181,16,21,Charles Gavin,40,Western Illinois,1,5,33,2018,2018
877,3,1,MAC,10,16,14,28,2,4,32,6,9,16,78,7,9,James Gordon IV,40,Toledo,1,7,17,2019,2018
878,14,1,Total,24,10,5,20,5,17,37,15,29,33,217,8,19,Derrick Green,40,Total,6,10,32,2020,2017
879,11,0,Southland,9,14,10,34,4,22,56,8,13,13,191,5,23,Orrin Greer,40,Texas-San Antonio,5,18,14,2008,2008
880,14,1,OVC,19,14,5,22,9,23,45,3,5,23,285,15,22,Kyle Gullett,40,Southeast Missouri State,7,9,34,2016,2016
881,7,0,Pac-12,5,15,7,20,8,23,43,2,2,43,93,0,7,Jacob Hazzard,40,Arizona,2,12,5,2016,2013
882,6,1,Big Sky,9,12,10,19,2,4,23,14,21,28,150,9,29,Bear Henderson,40,Eastern Washington,4,8,18,2016,2016
883,4,1,Big 12,8,14,3,3,11,21,24,1,2,13,73,1,12,C.J. Henry,40,Kansas,5,2,9,2010,2010
884,3,0,Southland,6,13,3,6,10,24,30,4,6,33,87,3,9,Paul Hiepler,40,Abilene Christian,2,3,9,2020,2018
885,2,2,Total,14,15,11,20,4,9,29,6,9,15,70,8,3,Tommy Hobbs,40,New Orleans,4,4,22,2014,2013
886,37,3,CUSA,26,12,5,22,7,26,48,9,14,26,315,0,26,A.J. Holland,40,Rice,18,28,26,2010,2010
887,2,9,Total,19,19,19,46,0,1,47,2,8,46,180,19,28,Brian Hornstein,40,Total,6,11,38,2015,2011
888,6,0,MVC,17,14,7,13,7,24,37,5,7,25,167,3,10,Monie Hudson,40,Evansville,1,4,20,2010,2010
889,34,2,OVC,40,14,14,32,0,5,37,12,34,28,336,7,35,Dontay Jackson,40,Jacksonville State,16,29,47,2015,2015
890,4,0,Big 12,6,12,1,3,11,41,44,5,7,33,183,1,13,Brock Jacobson,40,Iowa State,2,5,7,2008,2007
891,13,17,OVC,40,14,14,28,0,0,28,12,21,36,307,16,70,Waylon Jones,40,Southeast Missouri State,5,26,56,2012,2011
892,11,15,MWC,29,17,17,26,0,2,28,6,17,15,159,19,18,Kuba Karwowski,40,Utah State,7,6,48,2020,2020
893,3,4,Southland,20,14,13,26,1,11,37,11,12,28,220,17,32,Mari Kontae,40,McNeese State,6,6,37,2011,2011
894,7,1,Sun Belt,17,14,8,17,6,27,44,6,8,21,146,12,11,Milos Kostic,40,Appalachian State,3,8,29,2015,2015
895,7,5,Sun Belt,13,16,16,41,0,0,41,8,11,36,181,21,46,Braylon Lazare,40,Louisiana,5,9,34,2014,2013
896,6,1,Big West,29,13,5,12,8,34,46,6,11,16,170,4,20,Daniel Mading,40,UC-Riverside,0,10,33,2020,2020
897,7,0,OVC,8,11,1,6,10,36,42,8,10,20,185,7,25,Verkeneo Mann,40,Tennessee State,4,7,15,2011,2011
898,23,0,SWAC,11,14,5,13,9,21,34,3,6,19,195,8,29,Wendell Mardis,40,Alabama State,11,15,19,2008,2008
899,6,1,SWAC,40,16,16,41,0,1,42,8,12,37,290,10,55,Reginald Martin,40,Alabama A&M,8,25,50,2012,2011
900,5,3,Ind,13,14,9,21,5,27,48,7,14,38,231,7,30,Ivan Matip,40,Cal State Bakersfield,5,10,20,2012,2011
901,3,0,Total,11,14,4,11,10,34,45,2,2,33,177,3,23,Kyle McElvain,40,Texas-Arlington,5,6,14,2014,2013
902,12,1,NEC,5,9,6,31,3,16,47,19,23,23,175,5,22,Shelton Mickell,40,Central Connecticut State,9,20,10,2012,2012
903,6,20,CAA,41,17,17,37,0,0,37,6,9,46,384,42,57,Goran Pantovic,40,Drexel,7,14,83,2014,2011
904,28,39,SWAC,42,16,16,31,0,1,32,8,18,57,453,14,89,Chauncy Parker,40,Arkansas-Pine Bluff,16,37,56,2016,2015
905,4,1,OVC,18,17,17,36,0,0,36,6,14,17,162,14,31,Curtis Parker,40,Murray State,5,12,32,2007,2007
906,6,0,Big South,2,12,2,5,10,28,33,6,6,21,77,3,14,Casey Perrin,40,Campbell,3,5,5,2016,2013
907,4,1,Sun Belt,30,10,1,6,9,46,52,11,16,44,337,6,18,Josh Pierre,40,Arkansas State,8,6,36,2016,2013
908,13,0,Horizon,32,11,4,11,7,32,43,11,15,53,324,4,32,Kenny Pittman,40,Oakland,7,18,36,2020,2019
909,11,4,ACC,23,16,12,23,4,31,54,4,9,15,218,7,9,Asanti Price,40,Georgia Tech,10,18,30,2020,2020
910,22,2,AEC,27,15,15,26,0,1,27,10,21,28,223,9,24,Carl Ross,40,Albany (NY),9,16,36,2007,2007
911,3,0,WAC,5,12,0,4,12,32,36,4,4,28,133,4,8,Justin Salzwedel,40,Boise State,1,3,9,2011,2010
912,9,2,A-Sun,37,15,10,40,5,19,59,5,6,25,278,16,31,Qwanzi Samuels,40,Florida Gulf Coast,5,28,53,2020,2020
913,11,0,GWC,18,16,13,26,3,11,37,5,12,20,289,11,29,Archie Seals,40,Chicago State,11,20,29,2011,2010
914,2,5,Big South,28,19,19,30,0,0,30,2,6,31,187,15,25,Ricquall Smoot,40,Hampton,1,6,43,2019,2019
915,32,2,Big South,51,13,8,17,5,17,34,9,23,79,491,10,46,James Spencer,40,Liberty,12,32,61,2011,2008
916,21,0,Summit,6,14,11,23,3,6,29,9,20,18,145,2,23,Larry Stone,40,IUPUI,8,14,8,2009,2009
917,15,1,Horizon,26,16,16,43,0,8,51,8,17,45,214,19,35,Dan Studer,40,Milwaukee,9,14,45,2017,2015
918,7,5,Big Sky,9,14,7,16,7,17,33,5,6,14,142,5,8,Sebastian Suarez,40,Portland State,6,6,14,2015,2015
919,28,0,Ivy,19,16,13,33,3,11,44,5,16,34,286,4,29,Kashif Sweet,40,Columbia,13,32,23,2008,2007
920,16,3,Big East,16,13,4,8,9,20,28,5,8,40,170,1,11,Ted Talkington,40,West Virginia,6,10,17,2008,2007
921,7,1,A-10,25,13,6,25,7,26,51,7,8,24,266,9,20,Danny Thompson,40,Fordham,3,16,34,2010,2010
922,6,1,NEC,20,14,9,23,5,11,34,7,22,44,186,15,30,Milos Trivic,40,St. Francis (NY),10,14,35,2013,2011
923,16,7,Southland,35,15,11,31,4,28,59,6,6,25,377,15,20,Derek Van Vlerah,40,Incarnate Word,19,12,50,2020,2020
924,11,3,Big West,14,14,7,18,7,24,42,5,7,24,217,7,15,Lonnie Watson,40,Cal State Northridge,9,5,21,2013,2012
925,5,10,Southern,42,17,17,44,0,0,44,6,11,54,252,12,38,Daniel Watts,40,Elon,9,15,54,2011,2009
926,2,13,MAAC,37,15,15,31,0,0,31,10,13,40,194,20,48,Tyrell Williams,40,Iona,2,12,57,2018,2017
927,5,1,A-10,38,13,13,27,0,0,27,14,30,28,372,23,70,Zach Wing,40,Fordham,7,14,61,2009,2008
928,9,1,Big Ten,16,13,5,12,8,16,28,6,11,42,197,8,15,Mark Wohlford,40,Purdue,4,7,24,2010,2008
929,6,8,Horizon,20,10,6,19,4,16,35,15,21,31,122,12,9,Shaun Adams,39,Loyola (IL),5,8,32,2011,2010
930,30,0,WAC,27,18,17,41,1,9,50,2,5,47,373,6,30,Yonas Berhe,39,Louisiana Tech,5,27,33,2010,2009
931,2,7,OVC,14,11,11,24,0,1,25,17,23,33,179,13,25,Michael Birts,39,Southern Illinois-Edwardsville,1,11,27,2013,2012
932,10,5,NEC,28,12,6,16,6,39,55,9,22,46,292,10,23,Langston Burnett,39,Wagner,4,16,38,2015,2013
933,6,6,Ivy,13,17,16,31,1,5,36,4,8,28,96,6,15,Will Childs-Klein,39,Yale,2,11,19,2014,2012
934,7,0,SWAC,3,12,9,29,3,13,42,12,18,7,110,3,6,Tyler Corley,39,Mississippi Valley State,4,9,6,2015,2015
935,4,2,Total,15,15,15,34,0,0,34,9,15,25,185,11,22,Lewis Cramer,39,Total,4,6,26,2015,2013
936,18,0,NEC,14,15,14,31,1,7,38,8,14,32,196,1,25,DaRon Curry,39,Fairleigh Dickinson,3,14,15,2017,2016
937,5,0,MEAC,22,11,11,22,0,4,26,17,28,12,172,15,20,Juwan Davenport,39,Coppin State,7,18,37,2017,2017
938,5,0,Total,5,8,8,25,0,1,26,23,32,43,122,6,15,Angelo Davis,39,Savannah State,5,13,11,2014,2011
939,2,18,Total,53,17,17,48,0,0,48,5,20,60,388,40,84,Justin Davis,39,Total,5,17,93,2011,2008
940,2,5,Pac-12,31,14,14,30,0,4,34,11,22,36,205,17,43,Devenir Duruisseau,39,Washington,3,14,48,2018,2016
941,26,1,Southern,21,13,5,11,8,26,37,5,9,56,304,2,29,Zach Ferrell,39,Chattanooga,6,28,23,2009,2007
942,17,1,Big Sky,10,11,3,9,8,24,33,9,9,29,174,5,34,Will Ferris,39,Eastern Washington,3,12,15,2016,2016
943,4,4,Ivy,42,13,9,17,4,17,34,9,12,20,234,11,22,Marcus Filien,39,Cornell,11,9,53,2020,2020
944,1,4,Ivy,21,17,16,38,1,4,42,4,8,44,265,8,17,Jeff Georgatos,39,Harvard,3,9,29,2013,2010
945,4,3,Horizon,22,14,8,15,6,16,31,5,11,36,133,7,14,Quinton Gustavson,39,Milwaukee,2,4,29,2014,2012
946,2,0,Summit,26,10,4,14,6,14,28,13,18,23,161,13,20,Maleeck Harden-Hayes,39,North Dakota State,4,8,39,2020,2020
947,8,7,MVC,6,13,3,12,10,34,46,3,3,23,242,8,18,Lance Harris,39,Wichita State,11,17,14,2008,2007
948,3,16,WAC,60,15,15,41,0,0,41,9,15,58,501,33,95,Joe Henson,39,San Jose State,10,24,93,2012,2010
949,9,3,MAC,15,15,10,18,5,15,33,4,7,22,168,7,12,Malik Hluchoweckyj,39,Bowling Green State,8,9,22,2017,2016
950,4,3,Summit,16,12,9,14,3,8,22,12,22,21,93,8,15,D'Mauria Jones,39,Oral Roberts,5,3,24,2020,2020
951,3,3,AEC,13,17,17,33,0,3,36,5,8,20,125,14,26,Ryan Jones,39,Stony Brook,6,18,27,2007,2007
952,15,0,Big Ten,6,12,2,5,10,35,40,5,6,21,175,1,16,John Lickliter,39,Iowa,5,11,7,2010,2010
953,12,0,Summit,7,11,4,10,7,15,25,10,12,5,91,0,12,Nick Livi,39,Southern Utah,2,16,7,2008,2008
954,1,3,AAC,18,15,12,20,3,14,34,6,6,19,144,5,13,B.J. Mack,39,South Florida,2,4,23,2020,2020
955,7,14,Big West,22,18,18,38,0,0,38,3,5,20,166,13,30,Rundell Mauge,39,Pacific,10,10,35,2012,2012
956,5,4,Big 12,29,14,9,16,5,15,31,6,12,59,161,10,7,Pierson McAtee,39,Kansas State,3,7,39,2020,2017
957,8,0,MAC,7,13,4,7,9,22,29,4,4,50,134,1,9,David McKinley,39,Ohio,8,6,8,2013,2010
958,42,1,GWC,14,12,3,27,9,30,57,6,9,29,312,0,24,DeMarko Nash,39,Texas-Rio Grande Valley,12,35,14,2013,2013
959,10,6,ACC,28,15,15,27,0,3,30,9,15,23,181,18,24,Fabio Nass,39,Miami (FL),6,15,46,2008,2007
960,1,1,Southern,12,9,9,22,0,0,22,21,25,35,145,13,24,Niklas Ney,39,Mercer,0,10,25,2016,2015
961,16,1,NEC,21,13,8,24,5,15,39,8,11,34,254,9,13,Ross Pentland,39,Central Connecticut State,6,13,30,2010,2009
962,5,0,Sun Belt,5,13,3,9,10,30,39,3,3,13,125,3,3,James Perkins,39,Louisiana-Monroe,4,3,8,2007,2007
963,5,0,MAAC,8,8,4,12,4,21,33,19,26,57,105,2,18,Daniel Pillari,39,Monmouth,3,10,10,2018,2015
964,4,0,MVC,4,11,0,9,11,27,36,6,6,22,152,6,14,Tyler Ptacek,39,Evansville,1,9,10,2014,2014
965,9,1,CAA,22,14,13,45,1,2,47,10,12,35,221,24,24,Sean Raboin,39,Towson,7,9,46,2008,2007
966,19,0,Total,24,7,1,10,6,29,39,19,25,63,291,3,52,Varun Ram,39,Maryland,19,21,27,2016,2014
967,17,1,MAC,20,11,11,36,0,11,47,17,30,24,331,22,35,Jarelle Redden,39,Ball State,13,17,42,2007,2007
968,0,6,CUSA,28,17,17,30,0,0,30,5,5,13,161,9,33,Matthew Reed,39,Florida Atlantic,1,4,37,2016,2016
969,10,0,A-Sun,13,12,10,17,2,7,24,13,15,20,135,3,18,Lee Richmond,39,Jacksonville,9,11,16,2018,2017
970,6,6,MWC,7,16,16,33,0,0,33,7,9,10,95,10,13,Alton Robinson,39,Colorado State,6,15,17,2007,2007
971,42,1,Patriot,41,10,10,32,0,3,35,19,27,48,497,8,63,Rickey Royal,39,Army,22,39,49,2009,2008
972,4,3,Ivy,7,11,6,13,5,27,40,12,17,39,150,4,23,Thomas Ryan,39,Yale,7,10,11,2019,2016
973,4,0,CUSA,6,12,3,10,9,23,33,6,6,51,120,4,8,Greyson Sargent,39,East Carolina,1,6,10,2010,2007
974,5,1,Big East,7,13,3,8,10,26,34,3,4,10,140,5,13,Ryan Siggins,39,DePaul,1,2,12,2010,2010
975,2,0,Summit,11,14,13,26,1,9,35,10,10,13,86,10,3,Jarius Stevens,39,Purdue-Fort Wayne,3,4,21,2018,2018
976,25,0,SWAC,17,14,8,21,6,29,50,5,10,25,284,3,19,Brian Talley,39,Southern,4,27,20,2009,2009
977,7,0,Summit,9,14,12,22,2,4,26,9,10,8,102,4,9,Eules Thompson,39,Southern Utah,1,8,13,2009,2009
978,1,23,Total,36,14,14,32,0,0,32,11,24,41,221,20,63,John Underwood,39,Total,5,18,56,2012,2010
979,2,2,MWC,33,17,16,24,1,4,28,4,11,40,234,10,26,Rob Watsabaugh,39,Wyoming,5,11,43,2012,2010
980,15,0,Ind,21,16,13,39,3,14,53,4,7,19,226,13,18,Fredrick Wilson,39,Seattle,5,29,34,2011,2011
981,5,1,A-10,15,13,4,10,9,36,46,4,6,28,156,5,29,Luka Zivkovic,39,Fordham,4,10,20,2013,2012
982,2,4,SWAC,25,16,16,42,0,3,45,6,17,28,166,15,33,Wesley Afolayan,38,Prairie View,3,15,40,2015,2013
983,6,3,AAC,27,13,9,16,4,11,27,8,9,18,141,11,19,Madut Akec,38,South Florida,3,5,38,2020,2020
984,7,9,OVC,34,14,13,30,1,11,41,9,14,26,211,8,37,Bill Awet,38,Southern Illinois-Edwardsville,7,19,42,2019,2018
985,5,4,Pac-12,23,15,15,35,0,1,36,8,17,24,159,14,22,Wanaah Bail,38,UCLA,5,5,37,2015,2014
986,5,0,MEAC,16,12,5,20,7,30,50,7,9,19,195,2,12,Talmadge Bell,38,Coppin State,2,6,18,2007,2007
987,30,1,Big West,25,13,11,18,2,14,32,10,19,47,376,7,38,Olivier-Paul Betu,38,UC-Davis,13,30,32,2014,2013
988,5,0,Ivy,8,10,0,2,10,27,29,8,9,21,87,1,11,Alek Blankenau,38,Harvard,0,7,9,2008,2007
989,3,11,Total,18,15,15,25,0,0,25,8,17,28,138,10,20,Brandon Bolden,38,Total,3,14,28,2017,2013
990,5,1,ACC,15,12,7,13,5,8,21,9,12,19,103,3,5,Robert Braswell,38,Syracuse,9,9,18,2020,2019
991,1,1,WAC,8,13,13,22,0,0,22,12,14,14,89,3,14,Robert Brown,38,New Mexico State,2,4,11,2020,2019
992,3,1,MEAC,7,15,10,17,5,19,36,3,6,11,110,3,14,Trey Brown,38,North Carolina A&T,3,7,10,2015,2015
993,6,15,ACC,27,19,19,46,0,1,47,0,8,26,193,17,14,Jerome Burney,38,Maryland,2,4,44,2009,2008
994,7,4,Sun Belt,13,10,9,20,1,7,27,17,25,19,161,9,28,Justin Butler,38,Arkansas State,2,6,22,2010,2010
995,1,3,MAC,21,13,13,22,0,0,22,12,19,30,112,11,17,Milos Cabarkapa,38,Central Michigan,0,8,32,2016,2015
996,0,3,NEC,12,15,13,24,2,5,29,6,9,17,89,8,15,Chris Carter,38,Long Island University,2,7,20,2015,2014
997,14,0,MEAC,12,12,5,17,7,20,37,7,8,42,206,4,23,Whitley Carter,38,Savannah State,5,13,16,2015,2014
998,3,0,MEAC,5,15,9,17,6,17,34,2,6,20,130,3,11,Jerel Chavis,38,Delaware State,3,5,8,2008,2008
999,22,2,Patriot,28,12,12,27,0,9,36,14,26,26,379,14,22,Todd Checovich,38,Colgate,14,25,42,2007,2007
