,ast,blk,conf_abbr,drb,fg,fg2,fg2a,fg3,fg3a,fga,ft,fta,g,mp,orb,pf,player,pts,school_name,stl,tov,trb,year_max,year_min
0,2,1,WAC,7,8,3,6,5,17,23,4,6,26,85,3,7,Gentry Hunt,25,Chicago State,2,6,10,2017,2016
1,0,1,NEC,6,10,10,17,0,0,17,5,11,13,52,10,11,Precious Ikediashi,25,Saint Francis (PA),2,4,16,2020,2019
2,4,1,Summit,16,8,8,19,0,1,20,9,12,33,190,8,27,Brian Ishola,25,North Dakota State,3,8,24,2016,2015
3,19,0,CUSA,7,10,10,20,0,3,23,5,11,25,134,3,25,Jalen Jackson,25,North Texas,11,9,10,2020,2020
4,10,1,A-10,17,8,4,12,4,15,27,5,6,28,177,4,12,Xavier Jackson,25,Virginia Commonwealth,5,9,21,2019,2018
5,6,1,Big East,22,8,3,8,5,21,29,4,10,28,160,10,13,Dontarius James,25,Xavier,2,11,32,2020,2019
6,1,0,SWAC,4,12,12,17,0,2,19,1,6,16,86,2,10,Jordan Jefferson,25,Alabama State,1,8,6,2011,2010
7,8,1,Big East,21,12,12,30,0,0,30,1,2,43,279,19,35,Alex Kellogg,25,Providence,8,9,40,2009,2008
8,2,2,Patriot,12,10,5,12,5,15,27,0,0,26,124,5,29,Kerry Kenny,25,Lafayette,5,7,17,2007,2007
9,5,1,Total,12,10,5,18,5,17,35,0,2,32,64,1,2,Joshua Ko,25,Total,4,4,13,2018,2014
10,27,0,Total,26,6,5,21,1,26,47,12,18,60,415,6,39,Nathan Laing,25,Total,6,37,32,2018,2016
11,5,0,CUSA,3,6,3,12,3,9,21,10,16,38,71,4,5,Preston Laird,25,Memphis,0,5,7,2012,2009
12,1,0,MEAC,6,10,6,16,4,9,25,1,4,4,70,5,4,Jonathan Landry,25,Coppin State,2,0,11,2010,2010
13,3,0,Southern,8,9,5,10,4,12,22,3,5,21,109,8,9,Grant Ledford,25,Chattanooga,3,13,16,2020,2020
14,3,0,Sun Belt,6,9,5,9,4,6,15,3,7,12,46,0,0,John David Little,25,Middle Tennessee,1,3,6,2010,2010
15,4,1,AAC,25,10,6,13,4,10,23,1,2,25,141,3,20,R.J. McGee,25,Tulane,6,4,28,2020,2020
16,2,0,OVC,4,8,5,13,3,6,19,6,9,12,58,2,7,Jonathan Miller,25,Eastern Illinois,4,7,6,2012,2012
17,25,0,A-Sun,15,11,8,14,3,8,22,0,0,17,193,3,24,Wesley Mincey,25,Gardner-Webb,9,23,18,2007,2007
18,3,0,MAC,4,9,8,15,1,6,21,6,8,15,67,0,5,PJ Mitchell,25,Central Michigan,4,8,4,2020,2020
19,6,9,Big Ten,24,10,10,21,0,2,23,5,12,24,104,9,15,Clifton Moore,25,Indiana,4,6,33,2019,2018
20,17,0,Big South,9,10,6,9,4,17,26,1,6,19,113,0,6,Quinton Morton-Robertson,25,Radford,3,5,9,2020,2020
21,3,0,AEC,7,5,4,9,1,6,15,14,19,13,68,4,8,Joey Naccarato,25,Massachusetts-Lowell,0,4,11,2018,2018
22,3,2,Big 12,12,5,5,17,0,0,17,15,25,36,113,7,15,Ben Nelson,25,Nebraska,4,9,19,2010,2007
23,2,1,NEC,3,8,0,0,8,13,13,1,2,11,59,1,6,Devin Nicholson,25,Long Island University,1,2,4,2020,2020
24,1,0,Big South,3,8,1,4,7,20,24,2,3,25,80,0,1,Thomas Odom,25,Charleston Southern,0,3,3,2014,2011
25,1,4,SWAC,21,10,10,21,0,0,21,5,11,21,121,13,32,Robert Ojeah,25,Alabama State,1,8,34,2016,2015
26,1,0,Big South,13,9,6,12,3,10,22,4,9,42,99,4,16,Freddy Poole,25,Winthrop,5,9,17,2018,2015
27,5,0,Ivy,4,7,3,6,4,20,26,7,12,21,106,0,10,Matt Poplawski,25,Pennsylvania,2,7,4,2015,2014
28,4,0,SWAC,5,9,8,16,1,2,18,6,9,17,58,2,8,Donald Pritchard,25,Mississippi Valley State,3,8,7,2009,2009
29,1,0,Southland,14,8,7,17,1,5,22,8,15,31,124,8,27,Tyson Queen,25,McNeese State,2,6,22,2012,2011
30,1,0,Summit,9,7,3,6,4,10,16,7,8,12,52,2,10,James Rader,25,South Dakota State,0,4,11,2010,2010
31,1,3,Patriot,10,11,11,23,0,5,28,3,7,21,123,14,13,Malachi Rhodes,25,Bucknell,5,5,24,2020,2020
32,7,0,NEC,8,9,3,16,6,19,35,1,2,8,104,3,11,Elton Roy,25,Robert Morris,1,4,11,2011,2011
33,1,5,Big West,8,9,9,15,0,0,15,7,10,19,71,4,20,Solomon Ruddell,25,UC-Irvine,0,5,12,2019,2019
34,2,2,A-10,6,9,5,6,4,9,15,3,5,15,42,1,5,Clyde Santee,25,Massachusetts,1,3,7,2014,2014
35,1,2,MEAC,11,10,9,18,1,1,19,4,6,6,91,10,15,Rigoberto Sargeant,25,Coppin State,3,7,21,2009,2009
36,4,1,Southland,15,10,6,12,4,17,29,1,2,15,131,8,12,Corey Sato,25,Incarnate Word,3,8,23,2020,2020
37,9,0,CAA,16,8,8,21,0,0,21,9,19,28,226,8,18,Adam Savion,25,Hofstra,5,19,24,2014,2013
38,7,3,Big Ten,10,9,3,11,6,31,42,1,1,41,217,7,11,T.J. Schlundt,25,Wisconsin,4,4,17,2018,2016
39,2,0,Total,12,11,11,18,0,6,24,3,4,24,103,6,5,Jack Schoemann,25,Total,1,4,18,2020,2019
40,4,9,MVC,18,9,9,31,0,0,31,7,17,34,200,21,32,Darian Scott,25,Missouri State,3,12,39,2020,2019
41,6,0,OVC,14,7,4,16,3,12,28,8,9,16,147,10,21,Reggie Shellwood,25,Jacksonville State,6,10,24,2007,2007
42,4,2,Ivy,19,10,8,17,2,21,38,3,4,13,143,5,13,Cameron Shockley-Okeke,25,Columbia,7,10,24,2020,2020
43,4,1,Total,3,9,5,6,4,18,24,3,4,29,73,3,7,Rob Sisca,25,Total,2,2,6,2009,2007
44,10,1,Southern,12,9,6,20,3,14,34,4,7,45,239,4,24,Gerald Smith,25,Samford,3,6,16,2018,2015
45,8,0,Horizon,13,8,1,2,7,21,23,2,2,11,141,1,6,Blake Spellman,25,Northern Kentucky,2,7,14,2017,2017
46,6,0,WCC,10,10,7,13,3,15,28,2,5,22,131,4,8,Keith Stackhouse,25,San Diego,7,12,14,2013,2012
47,3,10,Big East,17,10,10,24,0,2,26,5,14,26,145,18,26,James Still,25,Providence,0,9,35,2010,2010
48,1,4,MAC,6,12,12,21,0,0,21,1,6,14,44,3,8,Steve Swiech,25,Akron,0,2,9,2010,2009
49,14,0,A-10,18,6,2,14,4,12,26,9,13,35,156,7,22,Myles Tate,25,George Mason,7,12,25,2017,2015
50,1,0,WAC,8,12,12,21,0,0,21,1,2,22,80,7,18,James Tchana,25,Fresno State,0,9,15,2008,2007
51,6,0,MAAC,18,9,5,9,4,6,15,3,5,17,121,6,7,Damani Thomas,25,Niagara,8,3,24,2020,2020
52,3,0,Southland,11,7,5,16,2,9,25,9,16,23,119,6,5,Kendrell Thompson,25,Sam Houston State,5,9,17,2009,2009
53,3,1,SEC,6,8,7,17,1,5,22,8,10,18,99,7,13,JoJo Toppin,25,Georgia,1,10,13,2019,2019
54,2,16,Horizon,15,11,11,17,0,0,17,3,12,29,118,10,37,Henry Uwadiae,25,Green Bay,1,15,25,2016,2015
55,1,0,SEC,12,7,4,5,3,18,23,8,13,37,106,3,8,Nathan Watkins,25,Vanderbilt,1,7,15,2016,2013
56,3,3,ACC,12,10,9,24,1,3,27,4,6,17,74,14,11,Malik William,25,Clemson,1,2,26,2018,2018
57,36,0,NEC,16,8,1,1,7,19,20,2,4,25,219,2,8,Lateff Willis,25,St. Francis (NY),3,20,18,2008,2008
58,2,4,SWAC,9,8,4,12,4,6,18,5,10,12,88,8,12,Payton Wilson,25,Jackson State,2,9,17,2018,2018
59,3,4,MVC,14,8,5,7,3,9,16,6,11,18,112,2,22,Jan Wojcik,25,Missouri State,7,7,16,2019,2019
60,3,11,MAAC,10,9,9,25,0,3,28,7,10,25,187,12,28,Derek Wolfley,25,Iona,6,26,22,2009,2009
61,0,5,OVC,9,10,10,22,0,1,23,5,12,19,133,12,24,Lamar Wright,25,Southern Illinois-Edwardsville,4,6,21,2020,2020
62,3,0,A-10,1,8,5,12,3,11,23,5,7,14,62,0,6,Jalen Adams,24,St. Bonaventure,3,2,1,2015,2015
63,6,0,AEC,14,8,6,14,2,5,19,6,8,29,144,9,10,Reid Anderson,24,Albany (NY),1,8,23,2008,2007
64,1,3,MAC,16,8,5,11,3,15,26,5,7,27,102,9,12,Derek Ballard Jr.,24,Eastern Michigan,3,2,25,2020,2019
65,2,1,Southland,8,9,8,14,1,10,24,5,8,13,60,6,4,Rex Baxter,24,Stephen F. Austin,5,5,14,2013,2013
66,4,2,OVC,11,10,9,18,1,6,24,3,5,10,73,7,3,Pedro Bradshaw,24,Eastern Kentucky,6,3,18,2019,2019
67,1,4,MAC,20,9,9,16,0,0,16,6,13,36,174,19,36,Blake Brown,24,Eastern Michigan,2,5,39,2017,2016
68,2,0,Big 12,24,10,10,20,0,3,23,4,14,51,133,8,24,C.J. Cole,24,Oklahoma,1,7,32,2017,2014
69,9,1,Big Sky,10,7,2,6,5,27,33,5,6,9,111,2,7,Josh Cornish,24,Southern Utah,5,3,12,2020,2019
70,5,0,GWC,17,7,7,13,0,0,13,10,16,18,178,7,21,Rakeem Couch,24,Texas-Rio Grande Valley,3,11,24,2010,2010
71,0,2,Sun Belt,8,11,11,14,0,0,14,2,4,10,35,6,5,Tyshaun Crawford,24,Georgia Southern,0,1,14,2019,2019
72,1,8,SWAC,12,9,9,18,0,0,18,6,9,24,162,12,36,Noah Cummings,24,Grambling,1,17,24,2017,2017
73,4,0,A-Sun,14,10,10,19,0,0,19,4,12,26,108,16,20,Ryan Daniel,24,Lipscomb,1,3,30,2008,2007
74,1,0,SWAC,23,8,8,16,0,0,16,8,13,30,157,11,44,Lavonne Davis,24,Prairie View,5,10,34,2017,2016
75,5,0,MVC,12,8,8,17,0,1,18,8,13,20,151,8,22,Matt Deady,24,Indiana State,10,9,20,2018,2018
76,4,1,WCC,24,7,4,14,3,15,29,7,12,18,131,6,26,Juan Ducasse,24,Santa Clara,3,13,30,2020,2020
77,0,1,Sun Belt,10,9,9,19,0,1,20,6,8,15,81,5,14,Harold Edwards,24,North Texas,2,11,15,2007,2007
78,3,3,Total,7,7,0,10,7,31,41,3,4,33,124,7,19,Jake Fay,24,Total,4,8,14,2017,2014
79,11,0,A-Sun,7,7,7,16,0,0,16,10,23,19,100,4,13,CJ Fisher,24,North Florida,2,9,11,2017,2017
80,11,0,Total,10,8,2,5,6,16,21,2,4,18,41,1,4,Beau Gamble,24,Total,2,5,11,2014,2011
81,3,1,A-Sun,8,8,5,12,3,8,20,5,8,16,81,4,9,Nick Goshay,24,Florida Gulf Coast,1,6,12,2011,2011
82,21,0,MWC,7,9,6,13,3,11,24,3,4,29,165,2,16,Chris Grant,24,Utah,8,12,9,2008,2007
83,9,1,Southland,13,8,8,16,0,3,19,8,13,11,113,7,18,Brian Hill,24,Texas State,5,10,20,2007,2007
84,5,1,Southern,12,10,10,22,0,0,22,4,7,19,125,5,23,Nigel Holley,24,East Tennessee State,0,8,17,2016,2016
85,4,20,A-10,34,9,9,29,0,0,29,6,9,49,241,11,32,Jake Houseknecht,24,St. Bonaventure,6,14,45,2012,2010
86,5,8,Total,24,7,7,15,0,0,15,10,21,40,204,10,57,Peace Ilegomah,24,Total,2,16,34,2020,2018
87,14,1,Big West,20,9,5,17,4,16,33,2,7,18,205,12,13,Delveion Jackson,24,UC-Davis,7,8,32,2018,2018
88,2,1,Big 12,9,8,6,15,2,4,19,6,9,9,64,9,13,Justin Jamison,24,Texas Tech,1,4,18,2015,2015
89,11,1,SEC,8,8,4,27,4,13,40,4,11,19,152,2,18,Branden Jenkins,24,Louisiana State,5,7,10,2017,2017
90,6,1,MAAC,17,10,8,14,2,8,22,2,8,19,113,12,11,David Johnson,24,Canisius,2,4,29,2008,2007
91,1,0,SWAC,2,7,6,8,1,5,13,9,13,5,57,0,5,Nicholas Jones,24,Arkansas-Pine Bluff,2,6,2,2020,2020
92,1,3,CUSA,8,8,1,2,7,20,22,1,2,22,91,4,7,Jacob Kilgore,24,Marshall,3,0,12,2017,2016
93,3,1,Pac-12,5,9,9,15,0,0,15,6,8,14,69,5,12,Marko Kovacevic,24,Utah,0,7,10,2014,2014
94,16,0,Southland,16,9,9,16,0,2,18,6,13,25,199,0,22,Diamante Langston,24,Abilene Christian,7,19,16,2017,2017
95,2,2,Big Sky,10,9,3,8,6,14,22,0,1,14,70,2,6,Jack Loofburrow,24,Eastern Washington,0,4,12,2008,2008
96,7,4,OVC,13,9,9,18,0,0,18,6,10,35,150,13,15,Alex Lubsey,24,Eastern Illinois,4,9,26,2013,2012
97,5,2,Total,12,9,4,14,5,10,24,1,1,36,92,3,12,Griffin McKenzie,24,Total,0,5,15,2014,2011
98,16,3,MWC,13,6,5,14,1,5,19,11,20,15,81,7,11,Ethan Michael,24,Air Force,2,7,20,2014,2013
99,3,0,SWAC,16,9,9,28,0,1,29,6,14,22,125,10,25,Ben Milshtein,24,Mississippi Valley State,1,7,26,2015,2014
100,0,1,Big Ten,4,9,5,8,4,12,20,2,7,44,101,7,17,Kevin Montminy,24,Penn State,2,2,11,2015,2012
101,1,6,MEAC,16,11,11,18,0,0,18,2,2,23,109,8,20,Chris Moore,24,Morgan State,4,5,24,2008,2007
102,5,0,MEAC,6,10,8,29,2,6,35,2,4,15,157,8,8,David Naves,24,Howard,5,18,14,2011,2011
103,2,2,WCC,15,12,12,30,0,1,31,0,8,19,130,7,19,Lazar Nekic,24,Loyola Marymount,4,10,22,2020,2020
104,0,4,SWAC,13,11,11,23,0,1,24,2,2,16,148,4,19,Jack Ocwieja,24,Grambling,0,5,17,2016,2016
105,3,3,Big West,9,7,7,18,0,1,19,10,13,24,108,3,24,Derek Oestreicher,24,UC-Davis,3,10,12,2009,2009
106,6,10,Total,15,10,10,21,0,0,21,4,11,33,179,10,32,Ugo Okam,24,Total,1,18,25,2015,2011
107,3,2,MAAC,10,9,9,20,0,2,22,6,16,18,150,8,28,Miles Orman,24,Marist,4,12,18,2007,2007
108,5,0,CUSA,9,5,3,8,2,9,17,12,14,16,69,1,7,Cameron Pappas,24,Charlotte,2,3,10,2016,2015
109,4,0,CUSA,21,8,2,9,6,17,26,2,3,12,113,1,15,Je'Quan Perry,24,Florida Atlantic,5,5,22,2018,2018
110,3,1,MEAC,26,7,7,21,0,5,26,10,14,22,256,11,38,Jeffon Powell,24,Bethune-Cookman,2,15,37,2015,2015
111,8,3,CAA,18,10,8,19,2,10,29,2,5,26,189,19,21,Danny Quinn,24,Towson,1,4,37,2011,2010
112,7,0,Big Sky,11,7,1,5,6,20,25,4,5,14,117,0,7,Mike Ranson,24,Northern Colorado,1,8,11,2017,2017
113,16,2,Sun Belt,11,10,10,23,0,0,23,4,6,24,159,13,22,Lorenzo Razz,24,Little Rock,7,8,24,2007,2007
114,5,9,MEAC,33,8,8,24,0,0,24,8,15,31,242,21,52,Phillip Reed,24,Hampton,1,12,54,2015,2014
115,8,12,AAC,31,9,9,34,0,0,34,6,23,32,254,17,59,Sammis Reyes,24,Tulane,11,17,48,2018,2017
116,8,0,Total,5,7,4,9,3,14,23,7,8,15,98,1,5,Julian Richardson,24,Total,3,5,6,2017,2015
117,19,5,A-Sun,50,9,9,32,0,0,32,6,13,41,438,30,37,Drew Romich,24,Total,4,18,80,2020,2016
118,2,0,Total,5,9,3,3,6,12,15,0,0,12,62,0,3,Alex Rossi,24,Total,1,5,5,2013,2012
119,12,1,MEAC,17,9,4,15,5,16,31,1,4,30,218,4,26,Justin Ryder,24,Delaware State,10,10,21,2019,2019
120,3,1,Big 12,16,9,3,6,6,18,24,0,0,21,99,5,15,Andrei Savrasov,24,Texas Tech,2,4,21,2020,2020
121,16,0,MAC,5,7,1,6,6,14,20,4,4,27,183,2,8,Richie Sebuharara,24,Buffalo,4,10,7,2013,2012
122,10,0,A-Sun,12,8,4,7,4,10,17,4,8,19,128,0,17,Michael Slonaker,24,Mercer,6,12,12,2007,2007
123,12,0,Southern,14,7,7,26,0,5,31,10,17,21,140,7,28,Sean Spooner,24,North Carolina-Greensboro,5,21,21,2009,2009
124,15,1,Pac-12,12,10,8,20,2,16,36,2,3,38,237,1,15,Hikeem Stewart,24,Washington,9,13,13,2014,2012
125,3,0,Sun Belt,10,6,2,9,4,11,20,8,9,17,86,2,4,Brooks Taylor,24,South Alabama,1,2,12,2007,2007
126,10,0,Big Sky,4,9,7,16,2,5,21,4,6,8,75,2,2,Deveric Taylor,24,Northern Arizona,1,4,6,2007,2007
127,27,5,Patriot,41,9,9,24,0,2,26,6,13,28,315,13,54,Whit Thornton,24,Army,4,31,54,2012,2012
128,2,1,Southland,7,10,8,24,2,5,29,2,8,16,111,8,27,Cade Towers,24,Nicholls State,2,8,15,2014,2014
129,5,0,Big Ten,8,6,6,11,0,8,19,12,18,35,102,5,12,Stephen Toyra,24,Purdue,2,11,13,2016,2013
130,4,2,Big Ten,13,8,8,18,0,5,23,8,11,25,126,13,16,Jordan Tyrance,24,Nebraska,2,9,26,2013,2012
131,2,4,CAA,38,11,10,24,1,10,34,1,5,21,184,14,28,Jesus Urbina,24,George Mason,5,14,52,2007,2007
132,7,11,Total,42,6,6,32,0,0,32,12,22,52,304,20,49,Bill Van Senus,24,IUPUI,4,7,62,2008,2007
133,8,1,A-10,4,9,4,9,5,16,25,1,2,8,125,2,8,Luka Voncina,24,Charlotte,3,10,6,2012,2012
134,4,1,Summit,7,12,12,21,0,1,22,0,2,28,112,5,15,Evan Wessenberg,24,North Dakota State,2,7,12,2017,2015
135,15,0,AEC,7,8,6,16,2,11,27,6,9,18,104,0,13,Naasir Williams,24,Vermont,2,7,7,2014,2014
136,4,0,MAAC,8,9,5,14,4,20,34,2,4,27,120,6,9,Pierson Williams,24,Loyola (MD),2,6,14,2012,2011
137,12,0,SWAC,11,9,7,19,2,17,36,4,10,21,148,1,22,Kareem Wright,24,Grambling,7,20,12,2018,2018
138,2,0,SWAC,8,9,3,6,6,20,26,0,0,22,123,3,9,Corey Young,24,Alcorn State,1,2,11,2015,2014
139,3,2,MWC,11,9,4,7,5,18,25,0,0,17,73,1,8,Riley Abercrombie,23,Boise State,0,4,12,2020,2020
140,2,6,Big Sky,17,9,9,17,0,0,17,5,10,21,202,11,44,Wandji Aboubakar,23,Sacramento State,3,9,28,2008,2008
141,2,0,MEAC,4,9,4,11,5,24,35,0,4,16,81,3,11,Nate Allen,23,North Carolina Central,2,5,7,2016,2016
142,0,0,Patriot,11,8,1,4,7,22,26,0,0,24,83,0,0,Dom Antonelli,23,Navy,2,5,11,2019,2016
143,2,5,Patriot,19,9,9,24,0,0,24,5,8,20,143,9,25,Tyler Barlow,23,Lafayette,3,2,28,2016,2016
144,12,1,Southern,5,7,6,21,1,5,26,8,14,16,129,8,16,Jaylen Beckham,23,Samford,8,21,13,2013,2013
145,13,0,MVC,10,5,1,9,4,13,22,9,11,20,188,2,17,Tomas Brock,23,Missouri State,4,14,12,2008,2008
146,8,0,MAC,11,7,5,17,2,11,28,7,11,13,138,2,14,Miles Brown,23,Ohio,8,11,13,2020,2020
147,1,0,OVC,4,7,1,11,6,25,36,3,7,31,112,3,9,Domas Budrys,23,Austin Peay,4,5,7,2017,2015
148,3,0,SWAC,9,9,9,21,0,0,21,5,11,14,95,8,28,Rudy Chestang,23,Alcorn State,3,7,17,2007,2007
149,1,2,MAC,11,8,8,15,0,5,20,7,12,10,67,5,9,Keenon Cole,23,Northern Illinois,1,3,16,2020,2020
150,3,1,MVC,8,9,7,12,2,9,21,3,5,32,66,5,1,Lincoln Conrey,23,Northern Iowa,1,6,13,2020,2017
151,0,1,CAA,9,9,9,15,0,0,15,5,13,3,55,4,8,Bryant Crowder,23,Hofstra,1,7,13,2012,2012
152,5,4,Big 12,20,8,4,8,4,17,25,3,6,16,162,8,28,Brock Cunningham,23,Texas,7,5,28,2020,2020
153,5,0,Big East,4,8,5,6,3,9,15,4,5,11,50,0,4,Chris Current,23,Louisville,2,0,4,2007,2007
154,6,0,Southern,3,8,8,20,0,4,24,7,10,10,69,7,5,Carlos Curtis,23,East Tennessee State,2,7,10,2019,2019
155,2,1,SWAC,0,8,3,5,5,17,22,2,4,10,96,3,4,Marceis Davis,23,Southern,1,4,3,2011,2011
156,8,2,CAA,8,8,4,12,4,13,25,3,9,17,114,2,5,Zyon Dobbs,23,James Madison,9,6,10,2020,2020
157,39,0,Total,25,8,5,13,3,12,25,4,10,93,538,5,61,London Dokubo,23,Loyola (IL),14,30,30,2015,2012
158,4,2,MEAC,20,10,9,31,1,11,42,2,9,19,142,13,13,Deven Dorsett,23,Maryland-Eastern Shore,3,9,33,2017,2017
159,6,0,Southern,6,8,4,12,4,9,21,3,5,11,72,2,8,Anthanee Doyle,23,Chattanooga,2,4,8,2014,2014
160,6,0,WAC,7,8,7,15,1,9,24,6,9,29,109,6,15,Jevon Estelle,23,Grand Canyon,2,7,13,2016,2014
161,2,9,OVC,18,8,8,16,0,0,16,7,10,14,166,13,12,Elochukwu Eze,23,Southern Illinois-Edwardsville,1,5,31,2019,2019
162,12,0,Big South,14,8,5,9,3,13,22,4,5,13,66,2,7,Jordan Faciane,23,Campbell,2,4,16,2015,2013
163,6,0,SWAC,4,8,3,4,5,10,14,2,3,2,61,3,4,Jonathan Floyd,23,Alcorn State,5,2,7,2019,2019
164,3,1,MEAC,3,7,6,13,1,2,15,8,15,8,39,2,8,Langston Gaither,23,Howard,2,6,5,2019,2019
165,1,1,ACC,15,9,9,20,0,0,20,5,13,26,96,11,14,Samson George,23,Pittsburgh,0,0,26,2020,2018
166,6,1,Big South,8,8,5,15,3,17,32,4,11,17,87,3,12,Rashad Gill,23,North Carolina-Asheville,6,8,11,2009,2008
167,4,3,Big South,11,8,6,6,2,6,12,5,9,24,82,5,7,Kyle Gonzalez,23,Radford,3,8,16,2016,2014
168,3,2,Pac-10,28,8,8,27,0,0,27,7,12,31,237,13,44,Taylor Harrison,23,University of California,4,10,41,2007,2007
169,1,0,ACC,3,7,2,6,5,12,18,4,4,26,58,1,4,Willie Herenton,23,Miami (FL),3,2,4,2020,2019
170,1,3,Big 12,10,7,4,6,3,12,18,6,9,25,69,3,6,Parker Hicks,23,Texas Tech,2,4,13,2019,2018
171,0,5,Total,13,10,10,18,0,0,18,3,9,36,145,6,38,Kevin Hickson,23,Total,11,7,19,2016,2013
172,1,0,SEC,2,9,5,12,4,15,27,1,2,22,36,2,3,Jonathan Holmes,23,Arkansas,1,3,4,2019,2017
173,4,0,AEC,12,6,5,15,1,6,21,10,10,12,91,4,21,Solomon Iluyomade,23,Maine,2,9,16,2020,2019
174,3,1,Big Sky,20,7,7,14,0,0,14,9,17,21,115,9,14,Danny Johnson,23,Weber State,4,12,29,2008,2008
175,2,3,Horizon,22,8,8,23,0,0,23,7,18,26,114,8,29,Larry Johnson,23,Youngstown State,5,5,30,2015,2014
176,6,3,CAA,14,6,2,9,4,15,24,7,12,16,159,3,23,Terrence Johnson,23,James Madison,10,8,17,2017,2017
177,1,18,Horizon,13,10,10,24,0,0,24,3,7,15,121,8,26,Isaiah Jones,23,Detroit Mercy,1,4,21,2018,2018
178,2,1,Southland,6,8,6,14,2,2,16,5,7,18,45,5,5,Nick Jones,23,Houston Baptist,1,2,11,2020,2019
179,3,0,OVC,22,7,5,12,2,10,22,7,11,46,115,4,21,Josh Lester,23,Belmont,0,5,26,2017,2015
180,3,1,A-10,3,7,3,15,4,7,22,5,12,32,62,3,4,O.J. Lewis,23,La Salle,5,5,6,2016,2013
181,6,3,Total,23,10,8,18,2,8,26,1,6,33,155,3,24,Merv Lindsay,23,Total,2,3,26,2014,2012
182,2,0,Summit,11,9,6,17,3,11,28,2,3,24,95,2,3,Ryan Maas,23,Western Illinois,1,6,13,2019,2016
183,0,3,GWC,10,8,6,14,2,7,21,5,12,28,95,3,14,Mike Mathison,23,North Dakota,1,11,13,2012,2011
184,18,1,CUSA,16,8,6,13,2,5,18,5,6,16,138,4,24,David McCoy,23,Southern Mississippi,7,23,20,2020,2020
185,2,3,AEC,8,11,11,23,0,0,23,1,1,28,89,3,9,Jordan McRae,23,Binghamton,2,3,11,2018,2016
186,10,6,Big Ten,14,9,7,15,2,20,35,3,13,61,197,5,30,James Mongomery,23,Northwestern,7,4,19,2014,2012
187,3,5,OVC,49,9,9,30,0,0,30,5,14,62,415,35,99,Pierre Mopo,23,Tennessee-Martin,7,19,84,2014,2011
188,6,0,Big 12,8,7,2,7,5,13,20,4,4,11,63,1,2,Tanner Ogden,23,Texas Tech,1,4,9,2007,2007
189,5,1,Southland,8,7,4,14,3,11,25,6,10,18,106,2,4,Masai Olowokere,23,Central Arkansas,1,8,10,2020,2020
190,1,10,Total,24,11,11,23,0,0,23,1,16,43,189,18,41,Jordan Omogbehin,23,Total,2,13,42,2015,2013
191,4,0,WCC,11,8,2,6,6,15,21,1,2,27,69,4,4,Kyle Perricone,23,Santa Clara,1,3,15,2013,2010
192,5,0,Big Ten,3,8,6,11,2,5,16,5,10,35,57,3,8,Corey Person,23,Michigan,0,5,6,2013,2010
193,7,0,CUSA,10,9,5,13,4,16,29,1,4,33,180,5,11,Alfis Pilavios,23,Old Dominion,3,6,15,2020,2018
194,0,2,SWAC,6,9,9,15,0,2,17,5,6,16,84,4,13,Noah Plain,23,Alcorn State,0,3,10,2019,2019
195,3,14,Big Sky,30,10,10,27,0,0,27,3,6,27,197,16,38,Quinn Price,23,Montana State,5,11,46,2016,2015
196,6,0,Total,8,9,5,12,4,11,23,1,2,26,99,2,5,John Reese,23,New Orleans,2,4,10,2014,2013
197,5,0,SWAC,6,8,1,3,7,27,30,0,0,8,79,0,10,Josh Robinson,23,Southern,3,5,6,2017,2017
198,4,1,Horizon,8,8,4,8,4,9,17,3,4,18,85,9,5,Derek Rongstad,23,Milwaukee,4,4,17,2017,2016
199,20,1,Big West,12,8,3,13,5,20,33,2,6,24,176,0,16,Ameer Shamsud-din,23,Cal State Fullerton,4,18,12,2009,2009
200,4,0,Total,5,7,0,2,7,22,24,2,4,32,56,1,1,Kevin Shaw,23,Georgia State,1,4,6,2014,2012
201,2,0,SWAC,3,9,7,13,2,7,20,3,3,3,38,1,3,Darius Simmons,23,Mississippi Valley State,2,3,4,2007,2007
202,7,0,SEC,11,9,7,14,2,8,22,3,6,14,101,1,7,Caleb Smith,23,Texas A&M,3,3,12,2017,2017
203,1,1,CUSA,13,10,10,17,0,0,17,3,5,21,180,9,34,Cory Smith,23,Southern Mississippi,2,12,22,2009,2009
204,5,0,OVC,8,7,2,6,5,14,20,4,6,32,118,4,10,Maverick Smith,23,Tennessee Tech,5,4,12,2020,2018
205,11,0,NEC,7,6,4,11,2,10,21,9,11,13,98,1,10,Declan Soukup,23,Bryant,6,8,8,2014,2014
206,11,0,OVC,9,8,6,10,2,3,13,5,9,12,100,4,10,Mario Stowers,23,Tennessee Tech,6,8,13,2008,2008
207,9,0,Total,13,9,6,11,3,15,26,2,2,30,317,2,32,Eric Strangis,23,Southern California,5,6,15,2012,2011
208,3,1,SWAC,20,7,7,19,0,0,19,9,19,27,204,7,32,Alvin Stredic Jr.,23,Arkansas-Pine Bluff,4,14,27,2020,2020
209,5,1,Horizon,13,8,1,3,7,21,24,0,1,31,123,2,4,Ryan Strollo,23,Youngstown State,4,5,15,2018,2016
210,10,0,Total,7,6,6,15,0,5,20,11,16,12,76,2,8,Atiba Taylor,23,Total,2,13,9,2020,2019
211,0,0,Big East,4,7,0,2,7,16,18,2,2,19,52,1,2,Moses Thijin,23,DePaul,1,0,5,2007,2007
212,3,7,WCC,20,8,8,16,0,0,16,7,14,26,122,2,14,Scott Thompson,23,Santa Clara,3,10,22,2009,2009
213,3,4,MAAC,14,8,8,11,0,5,16,7,11,9,90,2,16,Jarvis Vaughan,23,Monmouth,2,6,16,2020,2020
214,4,3,A-10,23,6,6,17,0,0,17,11,16,18,128,15,20,Randall West,23,Massachusetts,4,1,38,2020,2018
215,3,4,Total,18,9,9,20,0,3,23,5,9,22,113,8,22,Xavier Williams,23,Total,2,8,26,2017,2014
216,4,1,ACC,5,9,7,14,2,5,19,3,10,20,76,1,6,Avery Wilson,23,Boston College,6,11,6,2019,2018
217,3,0,Ivy,5,8,6,11,2,8,19,5,7,13,49,5,2,Zach Woolridge,23,Princeton,2,2,10,2008,2007
218,5,0,Pac-12,1,7,0,1,7,14,15,2,2,30,58,0,3,Alec Wulff,23,UCLA,3,1,1,2018,2015
219,10,0,SWAC,13,11,11,27,0,6,33,1,4,27,152,4,18,Jeremy Yates,23,Grambling,2,16,17,2008,2007
220,4,0,Sun Belt,6,6,3,7,3,5,12,8,8,16,39,0,4,Eito Yuminami,23,Georgia Southern,2,2,6,2020,2019
221,3,0,Summit,2,7,2,7,5,22,29,3,4,13,49,1,4,Robert Aery,22,Oral Roberts,1,3,3,2012,2011
222,1,6,Big Ten,19,9,8,14,1,2,16,3,7,21,114,9,18,Akol Arop,22,Nebraska,6,4,28,2020,2020
223,1,2,Big Ten,4,8,3,6,5,14,20,1,2,25,60,1,3,C.J. Baird,22,Michigan,0,3,5,2020,2018
224,5,2,SWAC,13,6,0,15,6,17,32,4,6,19,192,7,20,Charles Bargman,22,Mississippi Valley State,12,9,20,2015,2015
225,7,0,OVC,7,9,7,13,2,7,20,2,4,10,53,4,7,EJ Bellinger,22,Belmont,0,5,11,2020,2020
226,5,1,Patriot,12,7,5,16,2,9,25,6,11,28,196,4,19,Colton Bishop,22,Loyola (MD),4,9,16,2015,2015
227,4,0,Southern,5,8,2,8,6,10,18,0,0,13,41,1,7,Aaron Bond,22,Davidson,1,4,6,2010,2008
228,3,0,MEAC,10,10,10,16,0,2,18,2,5,6,75,2,8,Joel Boyce,22,Coppin State,4,11,12,2018,2018
229,8,0,CUSA,12,8,5,11,3,8,19,3,3,35,147,5,18,Bryson Brewer,22,Southern Mississippi,0,11,17,2010,2007
230,4,1,WAC,7,6,5,14,1,1,15,9,21,33,76,6,11,Tray Britt,22,New Mexico State,3,8,13,2010,2007
231,2,0,Horizon,1,8,2,3,6,19,22,0,0,8,43,2,3,Jerome Brown,22,Illinois-Chicago,0,1,3,2012,2012
232,2,0,Big Ten,8,9,9,17,0,7,24,4,10,11,76,7,9,Matt Bullock,22,Rutgers,1,5,15,2018,2017
233,4,0,Big Ten,13,9,5,6,4,7,13,0,1,38,126,7,18,Ryan Burton,22,Indiana,1,1,20,2016,2015
234,23,1,Ivy,33,9,5,15,4,21,36,0,1,27,307,2,15,T.J. Carey,22,Harvard,9,30,35,2008,2008
235,5,0,SWAC,8,7,7,10,0,1,11,8,14,7,55,4,6,Byron Carter,22,Mississippi Valley State,4,8,12,2007,2007
236,5,2,MAC,3,8,4,5,4,12,17,2,5,12,62,5,6,Anyeuri Castillo,22,Kent State,3,5,8,2020,2020
237,4,2,SWAC,8,9,7,15,2,6,21,2,5,29,188,7,39,Stephan Collins,22,Arkansas-Pine Bluff,2,12,15,2010,2010
238,2,11,Big Sky,20,9,9,20,0,0,20,4,7,21,116,8,17,Jordan Cooke-Harper,22,Sacramento State,1,8,28,2020,2020
239,4,0,OVC,2,6,2,6,4,9,15,6,6,14,51,1,10,Bryant Craig,22,Tennessee-Martin,1,2,3,2008,2007
240,22,0,Patriot,8,6,2,5,4,19,24,6,6,33,188,3,13,Cameron Curry,22,Boston University,6,9,11,2017,2014
241,2,4,Big South,24,8,8,27,0,0,27,6,11,16,160,13,11,Jamal Curry,22,Radford,3,12,37,2011,2010
242,0,4,SWAC,14,8,8,28,0,0,28,6,10,27,174,17,33,Andre' Davis,22,Southern,4,14,31,2009,2008
243,2,1,Total,16,5,4,12,1,2,14,11,17,19,101,5,17,Jermaine Davis,22,Total,0,12,21,2016,2014
244,4,0,Total,4,8,2,9,6,14,23,0,0,22,108,5,10,Luke Davis,22,Texas-Arlington,2,1,9,2014,2013
245,2,0,Total,9,7,3,9,4,18,27,4,7,24,71,1,14,Riley Dearring,22,Total,1,10,10,2017,2015
246,2,2,MEAC,25,7,7,33,0,4,37,8,16,42,,11,43,Darryl Demp,22,Florida A&M,6,6,36,2009,2008
247,3,1,SWAC,10,8,8,21,0,0,21,6,13,17,78,7,10,Fredens Deneus,22,Alabama State,2,5,17,2018,2018
248,10,0,NEC,5,9,7,11,2,5,16,2,7,17,117,4,6,Kyle Desmarais,22,Central Connecticut State,5,10,9,2009,2009
249,7,1,Total,34,10,10,41,0,2,43,2,7,27,185,17,23,Keondre Dew,22,Total,4,22,51,2017,2015
250,3,0,A-Sun,6,7,5,9,2,14,23,6,10,27,83,0,9,Cole Dewey,22,Campbell,1,7,6,2011,2009
251,1,6,MWC,20,10,10,22,0,1,23,2,9,19,130,7,23,Assane Diouf,22,Fresno State,0,12,27,2020,2020
252,0,2,CAA,11,8,7,13,1,7,20,5,6,25,92,2,18,Matt Elmore,22,North Carolina-Wilmington,1,3,13,2019,2017
253,0,1,Ivy,14,9,9,18,0,0,18,4,7,25,99,12,32,David Erebor,22,Brown,6,7,26,2018,2017
254,4,0,MEAC,10,8,8,13,0,2,15,6,9,17,69,2,6,Michael Fabiyi,22,Florida A&M,4,3,12,2013,2013
255,9,4,MAAC,25,4,4,15,0,0,15,14,19,59,366,27,54,Dan Ficke,22,Loyola (MD),4,16,52,2009,2007
256,1,5,OVC,18,8,7,18,1,3,21,5,8,18,106,4,18,Neville Fincher,22,Tennessee State,3,7,22,2016,2016
257,6,0,NEC,5,9,7,23,2,8,31,2,2,20,131,10,21,Austin Fowler,22,Saint Francis (PA),5,3,15,2010,2010
258,0,0,Big Ten,3,7,4,4,3,5,9,5,8,12,39,2,6,Grant Gelon,22,Indiana,1,1,5,2017,2017
259,21,0,Total,16,5,1,5,4,18,23,8,11,59,251,6,13,Zane Gibson,22,Middle Tennessee,8,10,22,2014,2011
260,5,0,SEC,7,9,8,11,1,4,15,3,3,20,74,4,10,Jamie Graham,22,Vanderbilt,3,7,11,2009,2008
261,5,0,Big Sky,16,8,4,5,4,22,27,2,5,18,96,1,7,Grant Greabel,22,Sacramento State,2,5,17,2020,2019
262,6,0,MAAC,11,8,3,5,5,23,28,1,2,42,115,9,24,Sean Grzeck,22,Fairfield,4,6,20,2010,2008
263,15,0,Patriot,7,6,2,13,4,11,24,6,10,13,113,0,14,Jalen Harris,22,Army,6,17,7,2012,2012
264,1,2,WCC,10,8,8,24,0,0,24,6,9,22,89,11,29,Ian Harward,22,Brigham Young,3,9,21,2013,2013
265,4,0,Southland,5,8,8,10,0,2,12,6,9,15,59,2,10,Hall Henderson,22,Stephen F. Austin,4,6,7,2007,2007
266,8,0,WAC,1,7,7,14,0,1,15,8,13,11,72,0,10,Simeon Henton,22,Chicago State,6,3,1,2018,2018
267,2,0,Ivy,5,8,8,16,0,2,18,6,8,13,96,3,11,Max Huc,22,Princeton,4,9,8,2009,2009
268,3,0,A-10,1,8,4,11,4,14,25,2,4,15,75,2,4,C.J. Jackson,22,Massachusetts,5,5,3,2020,2020
269,4,3,Big Ten,14,8,8,10,0,0,10,6,7,25,76,10,8,Charles Jackson,22,Illinois,3,10,24,2009,2007
270,4,0,A-Sun,7,5,5,11,0,4,15,12,16,37,130,9,25,Marquisse Jackson,22,Mercer,3,6,16,2012,2009
271,0,7,MAAC,16,10,10,28,0,0,28,2,5,12,163,15,32,Shawn Jackson,22,Iona,6,6,31,2013,2013
272,11,0,Sun Belt,11,9,5,11,4,15,26,0,0,20,121,0,18,Tavarres Jefferson,22,Middle Tennessee,6,9,11,2014,2012
273,2,5,GWC,19,10,10,30,0,0,30,2,6,26,157,18,20,Nick Jenson,22,Utah Valley,4,8,37,2010,2010
274,2,2,MEAC,13,8,8,36,0,1,37,6,8,19,142,6,10,Darryln Johnson,22,Coppin State,1,2,19,2013,2013
275,3,9,SWAC,25,4,4,21,0,1,22,14,28,41,209,21,46,Marcus Jones,22,Jackson State,3,20,46,2008,2007
276,1,1,AEC,10,7,7,16,0,1,17,8,19,9,100,8,26,Abby Kabba,22,New Hampshire,0,5,18,2009,2009
277,7,6,Big Sky,41,7,7,14,0,0,14,8,17,26,209,17,46,Tyson Kanseyo,22,Montana State,2,20,58,2016,2016
278,1,2,Pac-12,5,8,7,13,1,1,14,5,6,9,51,1,11,Austin Kuemper,22,Oregon,0,1,6,2013,2013
279,10,1,SEC,13,8,3,12,5,14,26,1,3,13,105,4,9,Roderick Lawrence,22,Mississippi,4,6,17,2015,2015
280,0,2,A-Sun,11,9,9,15,0,0,15,4,5,14,69,2,8,Leonard Livingston,22,Florida Gulf Coast,2,4,13,2013,2013
281,2,4,MAC,10,8,7,14,1,2,16,5,6,17,87,5,9,Mike Lochner,22,Northern Illinois,1,4,15,2007,2007
282,4,5,Southern,14,10,10,21,0,0,21,2,6,28,113,7,12,Michael Manning Jr.,22,Wofford,2,0,21,2019,2018
283,4,2,Ivy,13,7,5,12,2,6,18,6,12,21,80,4,19,Issa Mase,22,Columbia,2,12,17,2010,2009
284,18,3,Big Sky,13,9,9,17,0,4,21,4,10,19,143,10,30,Damani McEntire,22,Southern Utah,20,10,23,2020,2020
285,4,8,MVC,29,10,10,13,0,1,14,2,3,4,99,10,15,Michael Middlebrooks,22,Illinois State,4,4,39,2014,2014
286,4,3,SWAC,16,9,9,23,0,0,23,4,10,12,135,3,18,Tyler Miller,22,Prairie View,1,4,19,2016,2016
287,4,1,Total,6,6,4,13,2,4,17,8,10,19,92,4,13,Jamal Mitchell,22,Total,1,0,10,2015,2011
288,8,0,Patriot,6,7,4,8,3,21,29,5,8,37,100,5,5,Andy Moore,22,Lafayette,1,10,11,2011,2009
289,0,0,ACC,2,4,0,3,4,12,15,10,10,29,36,1,3,Joey Moreau,22,Florida State,1,2,3,2013,2010
290,1,0,WAC,3,6,1,3,5,10,13,5,8,8,38,0,4,Tennessee Owens,22,New Mexico State,1,1,3,2020,2020
291,1,0,Ind,4,9,5,12,4,9,21,0,0,9,53,0,5,Ian Persaud,22,Longwood,1,4,4,2010,2010
292,12,0,Big East,7,8,5,12,3,9,21,3,6,21,80,1,5,Trey Pettus,22,Butler,3,3,8,2017,2015
293,3,0,Sun Belt,2,9,5,20,4,13,33,0,0,20,139,1,8,Rob Phillips,22,South Alabama,1,8,3,2010,2010
294,4,0,AEC,1,7,6,14,1,1,15,7,11,11,79,1,12,Veljko Radakovic,22,Maine,4,7,2,2020,2020
295,3,10,A-10,28,8,8,20,0,0,20,6,9,27,187,16,37,Daniel Relvao,22,George Mason,4,12,44,2017,2017
296,8,0,WAC,4,10,9,22,1,6,28,1,3,21,115,7,18,Shawn Rouse,22,Boise State,7,12,11,2009,2008
297,3,0,WAC,15,5,5,16,0,4,20,12,17,19,103,1,14,Kaleb Roy,22,Missouri-Kansas City,2,7,16,2019,2019
298,1,2,NEC,12,9,9,24,0,0,24,4,10,8,91,7,9,DJ Russell,22,Robert Morris,0,2,19,2020,2020
299,3,0,A-Sun,5,7,6,22,1,2,24,7,11,24,129,9,16,Admir Sahbegovic,22,Jacksonville,6,12,14,2012,2012
300,1,0,Southland,6,8,2,4,6,24,28,0,0,28,122,1,7,Charles Saulnier,22,McNeese State,0,3,7,2008,2007
301,3,19,WCC,34,10,10,28,0,0,28,2,2,29,221,7,31,Andy Shannon,22,Pepperdine,4,8,41,2010,2009
302,34,0,Ind,11,10,10,20,0,0,20,2,11,19,201,4,21,Larry Sheppard,22,Texas-Rio Grande Valley,12,22,15,2007,2007
303,1,0,SEC,3,9,5,7,4,7,14,0,1,9,25,2,0,Nick Singleton,22,Mississippi State,0,2,5,2018,2018
304,1,4,Big Sky,10,10,10,14,0,0,14,2,7,24,196,9,30,Andre Slavik,22,Idaho State,2,10,19,2015,2014
305,9,0,SEC,11,6,2,7,4,15,22,6,6,15,104,6,12,Landon Slone,22,Kentucky,3,2,17,2009,2009
306,7,0,WCC,3,8,5,12,3,9,21,3,7,12,51,0,6,Brian Smith,22,Portland,0,5,3,2019,2018
307,4,2,Big Sky,7,10,9,11,1,5,16,1,6,9,52,2,2,Jerron Smith,22,Portland State,1,2,9,2012,2012
308,5,8,Big South,14,8,8,19,0,0,19,6,14,26,171,17,26,Pierre Sow,22,Hampton,4,7,31,2020,2019
309,4,0,Big South,6,8,7,16,1,14,30,5,7,20,94,5,8,Darius Steger,22,Coastal Carolina,1,12,11,2009,2009
310,8,0,Pac-10,7,8,5,8,3,16,24,3,6,15,94,2,7,Vojin Svilar,22,Oregon State,3,10,9,2007,2007
311,0,8,SWAC,9,8,8,16,0,0,16,6,10,18,67,4,22,Jamarious Sykes,22,Jackson State,0,3,13,2012,2011
312,0,7,CAA,22,7,7,16,0,0,16,8,12,29,126,10,19,Jamar Taylor,22,Georgia State,3,10,32,2012,2011
313,2,8,CUSA,20,8,8,16,0,0,16,6,12,10,127,5,12,Bryant Thomas,22,Charlotte,2,5,25,2018,2018
314,2,2,AEC,26,8,7,20,1,2,22,5,7,28,177,12,25,Shawn Tobey,22,New Hampshire,1,4,38,2008,2007
315,3,0,WAC,26,9,9,22,0,1,23,4,14,18,150,10,17,Theo Turner,22,Seattle,4,15,36,2015,2015
316,2,1,Big West,8,8,7,16,1,5,21,5,9,17,73,4,7,Aamahd Walker,22,UC-Santa Barbara,5,5,12,2014,2013
317,6,0,Sun Belt,3,8,4,20,4,9,29,2,3,16,103,2,12,Donovan Walker,22,Louisiana-Monroe,5,10,5,2018,2018
318,1,1,Total,12,7,7,22,0,2,24,8,11,17,96,10,19,Isaiah Watkins,22,Total,7,7,22,2016,2014
319,7,4,AEC,24,10,10,22,0,1,23,2,2,49,246,11,36,Dougal Weir,22,Hartford,3,8,35,2016,2014
320,15,1,Southland,12,7,6,18,1,9,27,7,8,29,140,1,12,Ryan Whitehead,22,Texas-San Antonio,2,10,13,2012,2011
321,7,1,Big 12,17,9,5,24,4,16,40,0,1,18,131,10,21,BillyDee Williams,22,West Virginia,4,4,27,2015,2015
322,2,0,OVC,4,7,7,13,0,11,24,8,10,6,86,0,2,Gerald Williams,22,Tennessee State,3,1,4,2014,2014
323,9,2,Big East,6,7,0,2,7,17,19,1,3,20,92,2,11,Paul Williamson,22,West Virginia,1,2,8,2012,2012
324,4,0,Big Sky,7,8,5,10,3,22,32,3,3,14,88,7,16,Devyn Wilson,22,Portland State,5,9,14,2018,2018
325,19,0,OVC,9,9,7,17,2,6,23,2,9,37,146,5,17,Shawn Wilson,22,Eastern Illinois,6,15,14,2020,2018
326,7,0,Big South,3,8,3,4,5,10,14,1,5,22,56,1,4,Kyle Witek,22,High Point,0,4,4,2008,2007
327,6,1,SEC,6,6,2,9,4,18,27,6,6,22,95,3,9,Brad Woodson,22,Tennessee,3,2,9,2019,2016
328,2,3,Southern,10,10,10,12,0,0,12,2,3,16,54,5,9,Neven Zeravica,22,Citadel,0,4,15,2008,2008
329,2,2,SWAC,15,8,8,13,0,1,14,5,13,14,99,5,9,Aaron Alston,21,Southern,4,8,20,2013,2013
330,2,5,CUSA,13,10,10,25,0,0,25,1,2,23,133,10,30,Jon Andersen,21,Tulane,7,8,23,2010,2009
331,20,0,Big 12,17,7,2,11,5,19,30,2,3,46,210,3,18,Michael Anderson,21,Missouri,8,13,20,2009,2007
332,2,0,ACC,9,7,6,12,1,8,20,6,11,27,132,2,21,John Auslander,21,Maryland,2,8,11,2014,2012
333,5,0,Pac-12,6,7,0,2,7,21,23,0,0,12,75,2,11,Eli Ballstaedt,21,Utah,2,2,8,2020,2020
334,2,0,SWAC,5,8,5,16,3,4,20,2,4,3,72,5,4,Demarkus Barnes,21,Mississippi Valley State,1,4,10,2007,2007
335,0,3,SWAC,11,8,8,25,0,0,25,5,9,12,78,16,16,Shaquille Benson,21,Southern,4,7,27,2018,2018
336,8,0,A-Sun,6,4,0,4,4,15,19,9,10,20,106,5,20,Kevin Boyle,21,Florida Gulf Coast,5,7,11,2014,2014
337,12,3,MAC,18,10,10,17,0,6,23,1,4,42,136,6,8,Tim Carroll,21,Akron,3,8,24,2010,2007
338,6,8,SEC,18,7,7,20,0,0,20,7,10,25,99,5,19,Jared Carter,21,Kentucky,1,13,23,2009,2007
339,5,0,MAAC,4,8,5,10,3,9,19,2,2,8,87,2,6,Brett Chance,21,Canisius,4,7,6,2009,2009
340,4,2,MWC,7,6,0,1,6,16,17,3,4,13,53,2,2,Ed Chang,21,San Diego State,1,5,9,2019,2019
341,8,0,Southland,12,8,6,15,2,9,24,3,3,9,108,9,13,Trevon Charles,21,Sam Houston State,4,4,21,2010,2010
342,2,0,CUSA,2,7,6,7,1,5,12,6,7,11,40,1,6,Tharone Chilton,21,Middle Tennessee,1,3,3,2014,2014
343,0,0,Horizon,14,4,4,10,0,4,14,13,16,23,84,0,14,Hans Christian Lauer,21,Illinois-Chicago,2,2,14,2016,2014
344,4,0,WCC,1,7,1,1,6,22,23,1,2,23,72,1,5,Quinn Clinton,21,Saint Mary's (CA),0,1,2,2020,2019
345,12,4,Big West,15,8,5,18,3,10,28,2,4,26,163,13,19,Chuck Coley,21,Pacific,4,13,28,2011,2011
346,6,0,ACC,8,8,5,9,3,17,26,2,2,23,80,1,6,Derek Craig,21,Georgia Tech,4,8,9,2012,2009
347,8,1,SEC,9,7,0,0,7,19,19,0,1,20,92,2,5,Preston Cranford,21,Arkansas,1,2,11,2007,2007
348,4,0,Big Sky,9,6,5,13,1,14,27,8,10,26,138,5,23,Tate de Laveaga,21,Northern Arizona,2,9,14,2015,2015
349,3,1,A-10,9,9,9,14,0,0,14,3,6,31,96,8,12,Chris Downing,21,Fordham,3,3,17,2019,2016
350,5,1,Big South,7,8,7,13,1,7,20,4,10,28,71,1,10,Tre Duncan,21,High Point,3,8,8,2015,2012
351,3,0,SEC,3,6,3,9,3,8,17,6,6,8,74,3,4,Kendall Durant,21,Alabama,1,7,6,2011,2011
352,3,1,Big South,2,8,6,9,2,3,12,3,4,7,26,1,1,Zach Durkee,21,Charleston Southern,1,1,3,2017,2016
353,3,1,Total,5,8,3,6,5,18,24,0,0,25,82,1,13,Grant Ellis,21,Total,0,4,6,2016,2014
354,1,3,Sun Belt,12,7,7,11,0,0,11,7,16,23,61,3,12,Austin Evans,21,Texas State,0,4,15,2016,2015
355,2,2,MWC,7,7,6,14,1,2,16,6,8,15,81,15,27,Ben Fakira,21,Utah State,1,7,22,2019,2019
356,5,0,A-Sun,4,6,4,5,2,4,9,7,8,8,42,1,4,Rendijs Feikners,21,Florida Gulf Coast,1,2,5,2017,2017
357,3,6,Total,14,10,9,12,1,10,22,0,2,34,166,4,19,Danny Feldmann,21,Total,3,9,18,2014,2011
358,2,1,CUSA,9,6,0,6,6,17,23,3,7,19,58,1,5,Noah Fischer,21,Marshall,0,2,10,2011,2010
359,4,0,NEC,2,7,5,10,2,5,15,5,10,21,48,3,5,Jordan Forehand,21,Saint Francis (PA),2,3,5,2019,2017
360,3,0,Big East,10,5,3,13,2,3,16,9,15,40,85,7,9,Robert Frozena,21,Marquette,3,5,17,2011,2008
361,2,0,MVC,7,7,6,24,1,1,25,6,12,31,84,12,10,Trevor Gregory,21,Evansville,6,8,19,2010,2007
362,2,0,SEC,1,6,5,16,1,6,22,8,12,12,42,4,6,Brian Halums,21,Mississippi,0,1,5,2019,2019
363,5,0,SWAC,3,7,2,3,5,20,23,2,4,25,171,1,7,Isaiah Haralson,21,Arkansas-Pine Bluff,2,10,4,2020,2020
364,2,0,MEAC,4,8,7,9,1,5,14,4,8,14,42,2,9,Danny Harris,21,Bethune-Cookman,1,11,6,2020,2017
365,4,1,WAC,11,7,5,19,2,7,26,5,12,21,129,4,15,O.J. Harrison,21,Utah State,8,8,15,2007,2007
366,9,1,Southland,6,5,5,13,0,3,16,11,15,14,95,2,11,Kelvin Henry Jr.,21,McNeese State,5,8,8,2018,2018
367,2,2,MEAC,9,7,4,13,3,14,27,4,7,15,101,8,5,Phillip Henry,21,South Carolina State,4,2,17,2013,2013
368,0,4,MAC,11,6,6,14,0,0,14,9,15,18,87,5,16,Dan Hess,21,Western Michigan,3,7,16,2008,2007
369,1,0,SEC,7,8,7,9,1,5,14,4,6,7,83,7,9,Jacquiese Holcombe,21,Mississippi State,2,10,14,2009,2009
370,11,5,OVC,32,6,3,14,3,14,28,6,15,30,318,4,62,Jason Holiday,21,Murray State,11,16,36,2020,2020
371,11,0,Total,4,7,3,7,4,16,23,3,6,33,103,2,17,Danny Hummer,21,Total,9,11,6,2020,2016
372,0,2,Big West,17,9,9,15,0,0,15,3,6,11,76,9,17,Tyler Jackson,21,UC-Santa Barbara,2,8,26,2017,2017
373,3,0,Ivy,10,7,7,14,0,1,15,7,13,10,43,8,7,Ed Jarvis,21,Yale,1,2,18,2020,2020
374,3,6,Pac-12,18,7,7,12,0,0,12,7,10,24,86,7,20,Jakub Jokl,21,Utah,0,6,25,2018,2017
375,37,1,CUSA,9,6,3,5,3,10,15,6,10,25,286,3,20,Charlie Jones,21,Houston,11,15,12,2007,2007
376,3,3,Sun Belt,8,10,10,21,0,0,21,1,8,30,93,10,15,Josh Jones,21,Middle Tennessee,3,5,18,2010,2009
377,6,0,Pac-12,5,8,7,17,1,8,25,4,6,9,61,2,6,Kenny Jones,21,UCLA,3,5,7,2012,2012
378,4,3,Big East,4,8,7,20,1,4,24,4,5,11,68,4,6,Mike Jones,21,Syracuse,2,3,8,2007,2007
379,2,0,CUSA,3,8,4,12,4,12,24,1,2,24,69,3,11,Mike Jones,21,Alabama-Birmingham,1,9,6,2011,2009
380,1,2,Ivy,9,8,8,22,0,0,22,5,9,11,65,6,7,Stefan Kaluz,21,Brown,2,1,15,2010,2009
381,2,4,WCC,19,9,9,15,0,0,15,3,11,20,128,15,28,Bronson Kaufusi,21,Brigham Young,5,4,34,2013,2013
382,10,0,SEC,17,5,0,4,5,19,23,6,17,49,188,2,25,Patrick Keim,21,Auburn,4,16,19,2018,2015
383,0,3,Big South,8,10,10,13,0,1,14,1,1,20,47,4,12,Tyler Kleckner,21,Radford,0,1,12,2008,2007
384,4,0,Big South,5,6,1,2,5,14,16,4,4,16,38,2,3,Tim Layer,21,Liberty,1,5,7,2008,2008
385,2,2,A-10,14,10,10,21,0,1,22,1,2,21,60,6,8,Mike Layssard,21,Rhode Island,0,4,20,2018,2017
386,8,3,Big 12,27,8,7,16,1,7,23,4,9,45,190,3,30,Cameron Lee,21,Iowa State,11,5,30,2009,2008
387,4,2,Big Ten,12,8,8,13,0,3,16,5,8,45,116,4,15,Sean Lonergan,21,Michigan,1,6,16,2017,2014
388,1,2,CUSA,28,5,5,12,0,0,12,11,17,32,153,6,41,Myles Luttman,21,Southern Methodist,1,16,34,2011,2010
389,2,27,Big East,23,8,8,19,0,0,19,5,11,45,203,11,46,Jonathan Mandeldove,21,Connecticut,2,14,34,2009,2007
390,2,7,NEC,15,6,6,17,0,2,19,9,14,38,105,7,7,Donyell Marshall Jr.,21,Central Connecticut State,2,6,22,2020,2017
391,0,0,OVC,9,8,8,16,0,0,16,5,6,15,65,9,10,Jamel Marshall,21,Morehead State,0,5,18,2010,2010
392,5,4,A-Sun,13,5,5,17,0,8,25,11,12,23,131,12,14,A.J. Martin,21,Mercer,5,18,25,2007,2007
393,3,4,OVC,10,7,5,7,2,8,15,5,7,6,62,2,9,Deyshawn Martin,21,Austin Peay,4,6,12,2018,2018
394,2,8,CUSA,20,8,8,16,0,0,16,5,10,26,138,12,13,TJ Massenburg,21,Middle Tennessee,1,7,32,2019,2019
395,13,0,MAC,15,7,3,12,4,11,23,3,5,39,235,6,21,A.J. Mathew,21,Toledo,13,6,21,2013,2012
396,2,8,MAC,16,7,7,16,0,0,16,7,20,28,203,20,34,Dwight McCombs,21,Miami (OH),5,14,36,2008,2008
397,11,0,CUSA,12,6,6,12,0,0,12,9,17,40,105,7,10,Chance McGrady,21,Memphis,1,6,19,2009,2007
398,2,3,Total,11,9,9,16,0,0,16,3,4,36,76,8,6,Collin McManus,21,Total,0,3,19,2020,2016
399,6,2,Big Sky,15,6,6,19,0,0,19,9,23,23,175,14,42,Rashano McRae,21,Eastern Washington,5,11,29,2011,2011
400,1,0,CAA,11,9,8,13,1,3,16,2,2,8,45,6,7,Jermaine Miranda,21,Hofstra,6,6,17,2020,2020
401,17,8,OVC,27,8,8,24,0,2,26,5,11,14,204,8,18,Damarri Moore,21,Tennessee State,7,24,35,2019,2019
402,4,0,SWAC,2,9,6,7,3,7,14,0,0,7,42,5,6,Jaime Morgan,21,Prairie View,2,1,7,2009,2009
403,2,0,MWC,2,8,5,7,3,10,17,2,4,21,49,0,4,Josh Morgan,21,Colorado State,2,4,2,2014,2013
404,2,2,Sun Belt,9,9,9,20,0,3,23,3,4,18,53,2,5,David Murray,21,Middle Tennessee,2,2,11,2010,2010
405,4,0,WCC,3,8,4,7,4,12,19,1,2,11,48,1,5,Greg Nelson,21,San Diego,2,6,4,2007,2007
406,9,0,A-Sun,8,6,4,6,2,23,29,7,16,35,135,6,25,David O'Shaughnessey,21,Mercer,5,8,14,2011,2010
407,1,3,NEC,9,9,9,19,0,0,19,3,4,15,71,5,7,Ola Olamuyiwa,21,Central Connecticut State,3,5,14,2020,2020
408,7,1,Big West,5,5,3,8,2,13,21,9,13,14,111,2,10,Clayton Osborn,21,Cal Poly,2,9,7,2007,2007
409,2,0,Big South,13,8,8,21,0,0,21,5,14,29,82,17,11,Stephen Osu,21,Presbyterian,1,6,30,2018,2015
410,10,14,CUSA,16,9,9,19,0,0,19,3,10,20,131,12,28,Grant Pelchen,21,Florida Atlantic,2,2,28,2014,2014
411,7,4,ACC,19,10,10,26,0,0,26,1,8,33,125,11,15,Karolis Petrukonis,21,Clemson,3,17,30,2010,2007
412,0,0,MEAC,6,7,3,7,4,16,23,3,5,11,62,3,2,Randell Pickett,21,Maryland-Eastern Shore,2,0,9,2017,2017
413,11,1,Pac-10,23,6,3,9,3,12,21,6,11,29,242,15,43,Alex Pribble,21,University of California,8,8,38,2007,2007
414,6,2,A-Sun,2,7,3,8,4,8,16,3,3,11,72,0,5,Josh Price,21,Liberty,0,4,2,2020,2020
415,3,0,Big West,2,7,2,7,5,15,22,2,3,23,54,2,11,Nick Quick,21,UC-Santa Barbara,2,4,4,2009,2008
416,1,3,MEAC,10,7,7,12,0,3,15,7,23,39,104,12,15,Jonathan Robinson,21,Hampton,9,10,22,2008,2007
417,1,0,Southland,6,6,0,1,6,18,19,3,4,20,79,0,4,Jason Rogers,21,Stephen F. Austin,2,1,6,2008,2008
418,2,9,Total,25,7,7,13,0,0,13,7,18,24,148,15,23,Obi Romeo,21,Total,3,4,40,2017,2015
419,6,0,SWAC,7,8,5,12,3,7,19,2,2,16,132,3,17,John Sanders,21,Mississippi Valley State,3,8,10,2016,2016
420,0,0,Ivy,9,9,9,18,0,0,18,3,6,11,82,8,17,Skylar Scrivano,21,Columbia,0,8,17,2013,2013
421,5,2,Total,3,7,7,25,0,7,32,7,10,47,102,0,22,Martin Shaw,21,Old Dominion,2,8,3,2016,2013
422,2,0,OVC,5,8,7,14,1,7,21,4,8,15,57,6,9,Derek Shoecraft,21,Tennessee State,3,4,11,2009,2009
423,0,2,Ind,10,7,2,6,5,16,22,2,3,24,104,3,8,Dwayne Sims,21,North Carolina Central,4,1,13,2011,2011
424,6,1,OVC,6,5,3,10,2,7,17,9,10,15,86,1,14,Randall Smith,21,Jacksonville State,2,11,7,2015,2015
425,5,0,CAA,5,8,7,13,1,4,17,4,5,15,63,8,15,Matt Stevenson,21,Drexel,1,3,13,2007,2007
426,4,1,ACC,1,7,3,7,4,13,20,3,7,18,95,1,10,Jonathan Thomas,21,Maryland,2,10,2,2012,2012
427,3,1,ACC,7,8,6,14,2,4,18,3,4,26,133,12,18,Chris Tucker,21,Virginia Tech,5,3,19,2007,2007
428,3,4,Big South,10,10,10,17,0,0,17,1,6,13,78,5,11,Bryant Wallace,21,Coastal Carolina,1,4,15,2008,2008
429,9,0,Ivy,18,10,9,18,1,14,32,0,3,46,113,2,8,Mike Washington,21,Princeton,2,10,20,2016,2013
430,0,0,CAA,0,7,1,5,6,15,20,1,2,26,56,1,0,Ben Whitlatch,21,William & Mary,2,1,1,2014,2011
431,6,0,Southland,4,6,5,15,1,9,24,8,13,18,106,7,9,Chasen Wiilliamson,21,Central Arkansas,5,4,11,2014,2014
432,8,0,A-Sun,9,5,2,10,3,11,21,8,10,14,87,2,11,JanAndre Williams,21,Lipscomb,1,8,11,2007,2007
433,2,7,Big Ten,20,7,7,11,0,0,11,7,15,48,151,13,34,Alan Wisniewski,21,Penn State,0,5,33,2015,2012
434,9,4,Big Sky,9,7,6,18,1,9,27,6,11,16,150,13,16,Mandrell Worthy,21,Montana State,7,10,22,2017,2017
435,4,3,Southern,20,8,5,13,3,11,24,1,2,24,152,3,31,Joe Aase,20,Davidson,3,4,23,2014,2014
436,6,3,Big Ten,8,9,8,13,1,6,19,1,5,40,109,4,29,Evan Anderson,20,Wisconsin,1,6,12,2014,2012
437,2,1,Big Sky,12,9,9,18,0,0,18,2,5,4,71,7,10,Kirk Archibeque,20,Northern Colorado,0,3,19,2008,2008
438,21,1,Big Sky,15,5,2,12,3,11,23,7,10,31,176,1,29,David Arnold,20,Northern Colorado,4,26,16,2011,2010
439,20,0,Big South,5,5,2,8,3,10,18,7,10,36,170,0,17,Kelly Assibesi,20,Liberty,4,13,5,2013,2012
440,0,2,Summit,9,4,4,8,0,1,9,12,18,14,62,5,13,Javonni Bickham,20,Denver,0,4,14,2020,2020
441,8,0,Big Sky,17,7,5,12,2,15,27,4,8,32,90,5,8,Thomas Blake,20,North Dakota,4,8,22,2017,2014
442,6,0,AEC,4,6,3,3,3,19,22,5,5,11,40,1,4,Jerrell Boswell,20,Maine,4,1,5,2010,2010
443,10,2,Summit,25,9,9,19,0,0,19,2,6,34,227,18,45,Daniel Brady,20,Missouri-Kansas City,5,14,43,2010,2009
444,5,0,AEC,4,6,3,7,3,23,30,5,6,14,92,2,9,Reece Brooks,20,Albany (NY),0,10,6,2019,2019
445,2,2,CUSA,11,8,8,12,0,0,12,4,6,19,141,13,29,Kahmell Broughton,20,Houston,5,3,24,2010,2010
446,2,1,Big South,15,9,9,17,0,0,17,2,2,14,118,3,23,Lorenzo Burgess,20,Charleston Southern,1,6,18,2007,2007
447,9,0,MAC,14,6,5,9,1,7,16,7,12,21,134,7,10,Jess Chadwell,20,Toledo,5,11,21,2011,2011
448,9,0,MEAC,4,6,3,13,3,9,22,5,8,14,65,3,10,Conrad Chambers,20,Morgan State,0,10,7,2015,2015
449,3,3,AEC,14,7,7,18,0,1,19,6,11,14,171,9,39,Kennedy Chukwuocha,20,Massachusetts-Lowell,4,15,23,2014,2014
450,1,0,Total,10,7,3,10,4,8,18,2,4,17,52,5,6,Grayson Clark,20,Georgia Southern,1,3,15,2015,2014
451,5,0,MAC,5,7,3,5,4,13,18,2,5,13,61,3,8,Eric Coblentz,20,Akron,2,1,8,2009,2009
452,10,0,Big West,9,8,4,17,4,16,33,0,3,21,113,0,12,Devin Cole,20,UC-Irvine,6,11,9,2020,2020
453,1,0,NEC,2,6,3,7,3,16,23,5,7,18,98,8,14,Garrett Constance,20,Wagner,0,3,10,2010,2010
454,6,0,OVC,1,7,7,17,0,5,22,6,9,26,86,2,5,Des Curry,20,Jacksonville State,2,3,3,2018,2016
455,9,0,MEAC,8,7,6,18,1,1,19,5,7,9,87,7,7,Jamaal Day,20,South Carolina State,4,7,15,2009,2009
456,10,1,A-10,5,8,4,7,4,24,31,0,2,22,129,4,18,Sam de Haas,20,St. Bonaventure,0,7,9,2011,2011
457,3,3,Total,37,9,8,29,1,14,43,1,3,37,232,13,32,Moustapha Diagne,20,Total,3,18,50,2020,2018
458,4,7,Big West,17,8,8,16,0,0,16,4,12,28,272,23,54,Justin Dueck,20,UC-Davis,3,10,40,2015,2013
459,8,0,MAC,10,9,8,27,1,1,28,1,2,25,207,2,33,William Eddie,20,Central Michigan,4,24,12,2009,2009
460,9,13,Big East,23,7,7,14,0,0,14,6,9,25,177,14,32,Mohamed Esseghir,20,South Florida,2,10,37,2008,2008
461,4,0,Big West,8,6,6,15,0,0,15,8,12,15,85,6,10,Keith Everage,20,Cal State Northridge,2,9,14,2007,2007
462,0,6,MEAC,14,7,7,17,0,0,17,6,12,37,119,11,23,Buford Foote,20,Morgan State,2,7,25,2010,2009
463,0,14,WAC,23,9,9,33,0,0,33,2,9,25,202,13,30,Jamal Gaines,20,Texas-Rio Grande Valley,3,7,36,2020,2020
464,2,0,Big West,10,7,6,13,1,13,26,5,8,16,102,1,0,John Gilliam,20,UC-Riverside,3,6,11,2012,2012
465,0,3,SWAC,10,9,9,24,0,0,24,2,2,20,94,10,11,Julian Gladness,20,Alabama A&M,2,8,20,2007,2007
466,0,1,Horizon,1,8,8,9,0,0,9,4,6,21,48,4,6,Stephen Gossard,20,Wright State,1,1,5,2014,2012
467,1,3,Total,4,8,8,11,0,0,11,4,7,17,58,7,9,Mason Green,20,Total,2,5,11,2020,2018
468,1,2,WCC,4,6,5,12,1,5,17,7,14,14,67,4,8,Trey Guidry,20,San Diego,2,4,8,2013,2013
469,1,1,Pac-12,8,7,5,15,2,4,19,4,7,13,53,6,9,Kenan Guzonjic,20,Colorado,0,6,14,2016,2016
470,2,0,SWAC,3,7,1,5,6,19,24,0,0,16,71,4,6,Quincy Hall,20,Grambling,1,5,7,2009,2008
471,6,1,OVC,5,7,4,14,3,9,23,3,4,17,71,0,9,Will Hamilton,20,Eastern Illinois,2,2,5,2009,2009
472,2,8,Summit,,9,9,19,0,0,19,2,5,20,,,,Brandon Harris,20,Centenary (LA),1,14,18,2009,2009
473,0,0,OVC,3,7,5,12,2,5,17,4,8,10,58,7,14,Jeremy Harris,20,Jacksonville State,3,3,10,2007,2007
474,3,0,A-Sun,2,6,1,1,5,14,15,3,4,12,44,0,1,Bruce Haynes,20,South Carolina Upstate,2,1,2,2013,2012
475,1,3,WCC,4,7,7,17,0,0,17,6,11,7,54,3,11,John Hegarty,20,Portland,0,4,7,2009,2009
476,2,0,Sun Belt,2,4,2,7,2,8,15,10,14,26,58,1,2,Adam Howard,20,Western Kentucky,1,8,3,2008,2007
477,1,1,Big South,10,9,9,11,0,0,11,2,4,17,80,6,13,Rob Huntington,20,High Point,1,10,16,2009,2009
478,1,3,Big West,16,4,4,19,0,0,19,12,20,18,131,12,22,Breyon Jackson,20,Cal State Long Beach,3,12,28,2020,2019
479,3,2,MAC,25,5,5,18,0,0,18,10,22,27,162,16,23,Chris Johnson,20,Northern Illinois,2,5,41,2020,2020
480,8,1,OVC,7,7,7,16,0,4,20,6,10,17,110,1,3,Deshawn Jones,20,Jacksonville State,2,14,8,2017,2017
481,2,5,MEAC,18,7,7,13,0,0,13,6,11,18,144,9,24,Brandon Jordan,20,Savannah State,1,7,27,2017,2016
482,1,3,CUSA,10,9,8,11,1,3,14,1,4,13,42,4,13,Alassane Kah,20,Old Dominion,1,1,14,2017,2017
483,3,1,ACC,15,8,5,7,3,12,19,1,2,22,52,1,5,Austin Katstra,20,Virginia,1,2,16,2020,2018
484,0,1,MVC,7,9,7,10,2,6,16,0,0,21,44,6,5,Cal Kennedy,20,Loyola (IL),0,2,13,2016,2015
485,9,0,Southern,8,8,4,11,4,17,28,0,0,19,122,2,7,Colin Kenney,20,Furman,1,5,10,2020,2020
486,7,0,Total,5,6,3,9,3,20,29,5,9,25,84,3,3,Eric Kindler,20,Total,3,7,8,2014,2011
487,11,2,MVC,15,6,4,13,2,7,20,6,11,27,196,3,31,Trey Knight III,20,Indiana State,9,10,18,2018,2017
488,4,0,MWC,18,7,5,14,2,18,32,4,6,31,152,7,23,Logan Lancon,20,Texas Christian,4,4,25,2010,2009
489,3,0,WCC,2,7,2,3,5,15,18,1,1,32,83,5,6,Matthew Lang,20,Gonzaga,3,4,7,2020,2019
490,22,0,Big 12,8,7,1,6,6,15,21,0,0,26,137,0,10,Logan Lee,20,Texas A&M,6,7,8,2007,2007
491,4,3,CUSA,5,8,5,12,3,16,28,1,2,27,181,9,15,Auston Leslie,20,Southern Mississippi,4,11,14,2020,2020
492,0,0,AEC,8,8,7,11,1,2,13,3,4,12,40,2,6,Terrel Martin-Garcia,20,Albany (NY),1,5,10,2017,2017
493,1,4,Southern,15,9,9,17,0,0,17,2,7,17,81,8,15,Trayvond Massenburg,20,Chattanooga,4,4,23,2017,2017
494,0,1,Ivy,2,7,2,2,5,8,10,1,2,21,38,3,3,Will McConnell,20,Dartmouth,0,1,5,2013,2012
495,3,0,Big Sky,10,7,3,7,4,21,28,2,2,19,130,3,8,Elijah McCullough,20,Sacramento State,4,5,13,2020,2019
496,2,1,Southland,14,5,5,14,0,0,14,10,14,9,73,6,7,Luke Mergerson,20,Texas State,2,1,20,2012,2012
497,1,0,SWAC,8,9,9,16,0,5,21,2,12,11,75,4,6,Dominique Miller,20,Alabama State,0,4,12,2013,2013
498,5,1,Horizon,12,8,8,16,0,1,17,4,6,17,96,5,21,Milos Milosevic,20,Valparaiso,1,9,17,2010,2010
499,3,0,Patriot,5,8,7,15,1,4,19,3,3,8,69,7,15,Andrew Morrison,20,Bucknell,0,3,12,2007,2007
500,1,6,MVC,10,8,7,19,1,4,23,3,5,10,107,8,14,Ty Morrison,20,Creighton,4,6,18,2007,2007
501,6,3,CUSA,25,9,8,9,1,4,13,1,2,23,114,5,15,Lawrence Mosley,20,Middle Tennessee,2,5,30,2019,2019
502,4,0,AEC,7,7,1,6,6,19,25,0,0,11,94,2,6,Skyler Nash,20,Vermont,1,6,9,2019,2018
503,0,2,SEC,6,8,8,18,0,0,18,4,8,22,71,15,11,Rawane Ndiaye,20,Tennessee,0,8,21,2014,2014
504,21,0,Summit,16,7,3,17,4,15,32,2,6,39,234,6,17,Devin Newsome,20,Omaha,6,13,22,2016,2015
505,3,0,Pac-12,9,5,4,21,1,8,29,9,9,18,101,5,13,"Charles O'Bannon, Jr.",20,Southern California,6,5,14,2020,2018
506,0,7,A-Sun,11,9,9,20,0,0,20,2,4,23,129,15,33,Phillip Okonma,20,Jacksonville,1,15,26,2007,2007
507,1,0,CUSA,8,8,5,10,3,15,25,1,3,6,65,7,5,Roderick Ollie,20,Alabama-Birmingham,3,4,15,2007,2007
508,11,0,AEC,26,2,1,18,1,9,27,15,21,20,232,10,26,Chris Orozco,20,New Hampshire,5,16,36,2013,2013
509,13,1,A-10,15,7,5,29,2,19,48,4,5,23,202,15,20,Dominic Osei,20,Fordham,5,14,30,2007,2007
510,23,0,Summit,11,6,6,10,0,2,12,8,9,19,138,1,10,Jalen Packer,20,Western Illinois,6,14,12,2012,2012
511,3,1,Big East,11,8,6,12,2,10,22,2,7,15,70,4,11,Kobe Paras,20,Creighton,2,4,15,2017,2017
512,4,1,MVC,10,7,6,10,1,4,14,5,11,42,148,4,19,Cory Parker,20,Drake,4,3,14,2012,2010
513,4,3,SWAC,11,8,8,21,0,0,21,4,9,18,149,8,18,Ryan Parker,20,Alabama A&M,3,8,19,2007,2007
514,6,12,CUSA,19,7,7,13,0,0,13,6,15,33,194,13,50,Michael Phillip,20,Florida International,0,3,32,2015,2015
515,4,0,Big 12,10,8,8,17,0,6,23,4,7,8,77,9,5,DeMarcus Phillips,20,Iowa State,2,4,19,2011,2011
516,1,3,Big South,9,8,8,20,0,8,28,4,8,6,92,4,13,Terence Porter Jr.,20,Charleston Southern,2,9,13,2020,2020
517,2,0,MAC,4,6,2,8,4,10,18,4,6,7,54,2,6,Marvin Price,20,Ohio,5,2,6,2020,2020
518,1,2,Big West,7,8,8,16,0,3,19,4,11,15,102,4,17,Jacob Ranger,20,UC-Davis,2,9,11,2010,2010
519,3,0,A-Sun,6,7,1,3,6,14,17,0,2,19,91,0,8,Colton Reed,20,Liberty,1,2,6,2020,2020
520,15,2,MAAC,7,4,1,9,3,21,30,9,12,26,156,5,23,Romar Reid,20,Manhattan,1,19,12,2020,2020
521,4,0,Southern,3,5,1,5,4,8,13,6,11,16,45,6,6,Dillon Reppart,20,East Tennessee State,2,2,9,2018,2017
522,0,0,WAC,3,7,1,3,6,10,13,0,1,10,34,1,3,Bryce Rewalt,20,New Mexico State,0,1,4,2020,2020
523,4,0,A-10,8,7,3,11,4,14,25,2,2,22,97,1,13,Chase Robinson,20,Duquesne,2,5,9,2010,2009
524,6,0,ACC,3,6,0,3,6,19,22,2,5,13,52,0,6,Patrick Rooks,20,Clemson,3,0,3,2015,2015
525,0,0,ACC,7,8,4,7,4,10,17,0,0,14,34,4,2,Michael Saxton,20,Florida State,1,1,11,2016,2015
526,2,0,MAC,7,8,7,16,1,14,30,3,4,14,93,3,9,Christian Schmidt,20,Buffalo,1,8,10,2008,2007
527,1,1,Big Sky,6,7,6,10,1,2,12,5,6,6,55,4,5,Junior Searcy,20,Northern Arizona,0,2,10,2016,2016
528,13,0,Big Ten,5,8,7,19,1,5,24,3,9,44,160,9,16,Wquinton Smith,20,Wisconsin,6,8,14,2011,2008
529,1,1,MEAC,23,9,9,24,0,0,24,2,2,25,196,10,33,Jayson Snearl,20,Florida A&M,3,8,33,2015,2015
530,3,5,WAC,12,9,9,18,0,1,19,2,5,8,84,12,16,Jalen Stephens-Holmes,20,Chicago State,2,6,24,2018,2018
531,1,0,OVC,12,5,2,13,3,23,36,7,14,17,103,10,8,John Summers,20,Tennessee State,2,5,22,2007,2007
532,2,1,SWAC,4,4,0,5,4,14,19,8,12,26,67,2,2,Kyle Swanier,20,Jackson State,1,9,6,2010,2007
533,7,0,MWC,16,7,3,6,4,11,17,2,4,25,139,2,17,Ryan Teets,20,Air Force,2,9,18,2007,2007
534,2,2,Big West,20,8,8,18,0,0,18,4,9,15,122,7,13,Morgan Tilford,20,Cal State Northridge,6,6,27,2013,2013
535,3,10,Ind,14,10,10,26,0,0,26,0,5,7,95,8,27,Abel Tillman,20,Southern Illinois-Edwardsville,3,8,22,2011,2011
536,6,0,WCC,16,7,5,11,2,9,20,4,10,46,109,1,10,Evan Troy,20,Brigham Young,1,8,17,2020,2018
537,3,1,Ivy,8,9,7,18,2,7,25,0,0,9,92,1,18,Eddie Turner III,20,Columbia,6,10,9,2020,2020
538,18,0,Big Sky,19,7,5,12,2,12,24,4,9,14,186,6,7,Eric Turner,20,Weber State,8,18,25,2007,2007
539,0,0,Big West,13,6,2,4,4,17,21,4,6,15,106,3,7,Floris Versteeg,20,Cal State Fullerton,1,5,16,2014,2014
540,3,3,GWC,18,9,9,17,0,0,17,2,3,20,93,3,15,Calvin Walker,20,Texas-Rio Grande Valley,0,5,21,2011,2011
541,2,1,Patriot,11,6,2,6,4,14,20,4,5,16,131,3,8,Jaylen Walker,20,Navy,4,5,14,2020,2020
542,3,0,NEC,4,4,2,4,2,4,8,10,10,13,48,0,1,Jermaine Washington,20,Central Connecticut State,1,3,4,2008,2008
543,7,1,NEC,11,4,0,6,4,17,23,8,11,21,107,1,7,James West IV,20,Mount St. Mary's,4,8,12,2019,2018
544,7,1,Big 12,4,6,3,5,3,4,9,5,6,14,76,1,9,LucQuente White,20,Texas Tech,3,8,5,2007,2007
545,3,5,Horizon,14,9,9,20,0,0,20,2,11,21,165,20,33,Taveion White,20,IUPUI,5,7,34,2020,2020
546,0,0,SEC,1,8,4,7,4,8,15,0,0,9,34,4,3,Donald Williams,20,Mississippi,1,4,5,2011,2011
547,4,0,Horizon,3,9,9,14,0,0,14,2,4,3,32,4,4,Tanner Williams,20,Loyola (IL),2,2,7,2013,2013
548,1,0,Pac-12,8,5,0,2,5,17,19,5,6,47,88,2,1,Austin Witherill,20,Arizona State,0,1,10,2018,2015
549,0,2,SEC,7,8,4,8,4,10,18,0,0,25,62,4,6,Adam Wolf,20,Missouri,3,0,11,2019,2016
550,2,4,SWAC,24,9,9,13,0,1,14,2,7,19,189,16,43,Yusef Yakubu,20,Prairie View,4,11,40,2017,2017
551,19,0,WCC,12,7,6,10,1,11,21,5,7,32,169,4,29,Aitor Zubizarreta,20,Portland,11,20,16,2015,2014
552,2,0,Southern,12,7,5,8,2,8,16,3,5,44,91,4,11,A.J. Atkinson,19,Davidson,0,3,16,2012,2009
553,13,1,Big South,10,5,5,12,0,4,16,9,14,12,101,3,14,Aaron Austin,19,Radford,6,13,13,2009,2009
554,4,0,MAC,7,5,4,9,1,1,10,8,9,18,49,1,4,De Andre' Austin,19,Bowling Green State,4,3,8,2019,2018
555,6,0,WCC,14,4,1,2,3,15,17,8,13,49,97,2,12,Rem Bakamus,19,Gonzaga,6,5,16,2017,2013
556,5,3,MWC,15,6,5,18,1,5,23,6,12,17,89,6,10,Colt Barnhill,19,Air Force,6,3,21,2012,2012
557,2,0,ACC,8,7,2,2,5,23,25,0,3,24,39,3,5,Staats Battle,19,North Carolina State,0,1,11,2015,2012
558,2,2,MEAC,9,6,6,12,0,0,12,7,13,19,75,9,5,Dominique Behonh-Tolly,19,North Carolina A&T,1,4,18,2013,2012
559,3,0,MEAC,12,6,3,15,3,16,31,4,8,7,110,3,12,Randall Black,19,South Carolina State,0,10,15,2013,2013
560,4,2,MWC,15,7,7,14,0,0,14,5,7,41,138,8,37,Adam Brakeville,19,Air Force,3,6,23,2012,2010
561,1,0,Summit,2,7,5,12,2,8,20,3,8,18,53,0,10,Peter Bunn,19,Oakland,7,6,2,2008,2008
562,8,0,Summit,7,5,5,15,0,3,18,9,11,16,94,1,7,Cortell Busby,19,IUPUI,2,9,8,2014,2014
563,2,1,Pac-12,15,8,7,12,1,1,13,2,4,11,71,9,7,M.J. Cage,19,Oregon,0,3,24,2018,2018
564,4,0,Big South,21,7,7,17,0,0,17,5,9,42,229,4,29,Jake Campbell,19,Presbyterian,2,9,25,2015,2013
565,15,3,Patriot,16,8,6,16,2,5,21,1,4,17,149,1,11,Jordan Coleman,19,Army,4,8,17,2020,2019
566,2,1,Southern,7,7,3,8,4,8,16,1,1,11,53,5,8,Jared Collins,19,Georgia Southern,1,7,12,2008,2008
567,5,0,NEC,5,6,5,13,1,8,21,6,7,11,72,1,7,Khalief Crawford,19,Merrimack,2,8,6,2020,2020
568,8,1,Sun Belt,23,6,3,13,3,10,23,4,11,16,143,8,10,Akiem Daschner,19,Texas State,6,9,31,2019,2019
569,0,0,Big South,19,5,5,21,0,0,21,9,17,13,185,11,26,Abraham Deng,19,Longwood,3,11,30,2020,2020
570,18,2,Summit,6,3,1,6,2,15,21,11,16,27,135,3,12,Nick DeSchepper,19,IUPUI,7,13,9,2011,2010
571,2,15,MAAC,17,9,9,12,0,0,12,1,3,36,155,7,20,Marial Dhal,19,Canisius,0,16,24,2012,2011
572,0,1,Total,10,9,9,22,0,0,22,1,1,8,107,4,12,Horace Dixon,19,Total,3,11,14,2010,2007
573,2,2,Summit,16,5,5,12,0,1,13,9,12,14,44,4,4,Logan Doyle,19,South Dakota State,1,2,20,2016,2015
574,1,0,Ivy,9,7,5,12,2,4,16,3,8,33,62,8,7,Daniel Edwards,19,Princeton,2,9,17,2015,2011
575,5,0,Southern,12,6,1,3,5,15,18,2,2,17,113,1,14,Douglas Elks,19,Western Carolina,1,6,13,2020,2020
576,4,3,CAA,16,7,2,7,5,13,20,0,0,21,112,3,8,Quirin Emanga,19,Northeastern,3,5,19,2020,2020
577,2,1,MWC,4,7,2,3,5,15,18,0,0,16,30,1,3,Niksha Federico,19,San Diego State,1,0,5,2016,2014
578,1,1,Ivy,7,7,4,11,3,7,18,2,8,10,63,3,2,J.T. Flowers,19,Yale,1,1,10,2014,2014
579,12,1,WCC,10,7,5,11,2,14,25,3,8,28,129,1,11,Greg Foster Jr,19,Gonzaga,4,9,11,2019,2019
580,1,0,NEC,6,7,7,16,0,0,16,5,10,7,58,6,12,Mike Gabriel,19,Quinnipiac,1,2,12,2011,2011
581,2,1,MAC,5,7,7,13,0,4,17,5,7,15,62,7,11,DeAndre Gholston,19,Kent State,4,7,12,2019,2019
582,8,1,AEC,7,6,5,9,1,5,14,6,9,24,122,0,10,Tanner Gibson,19,Albany (NY),5,2,7,2012,2012
583,2,0,Pac-12,1,4,4,11,0,2,13,11,15,18,36,1,5,Brenden Glapion,19,University of California,0,2,2,2016,2015
584,6,0,Total,5,5,2,5,3,11,16,6,7,29,46,3,3,Nick Goff,19,Total,1,4,8,2013,2010
585,2,0,WAC,5,5,0,3,5,13,16,4,5,14,43,0,3,Jordan Gonzalez,19,California Baptist,1,5,5,2020,2019
586,18,0,Ivy,7,5,4,8,1,8,16,8,13,27,107,3,6,Ari Greenberg,19,Yale,8,6,10,2008,2007
587,0,6,MAAC,12,8,8,17,0,0,17,3,6,28,98,15,11,Erik Harris,19,Siena,3,8,27,2009,2008
588,2,2,Big Sky,24,8,8,22,0,2,24,3,6,28,160,20,19,Jaylen Henry,19,Eastern Washington,2,6,44,2012,2011
589,6,0,Total,6,4,3,4,1,7,11,10,11,22,49,2,9,Sam Hershberger,19,Elon,1,1,8,2016,2013
590,4,0,MEAC,6,7,6,19,1,4,23,4,8,13,88,7,11,Rasool Hinson,19,Coppin State,6,9,13,2017,2017
591,1,0,Southland,3,4,0,5,4,9,14,7,7,17,67,0,12,Jaxon Holden,19,Stephen F. Austin,1,4,3,2015,2015
592,7,2,A-10,11,7,5,8,2,8,16,3,6,40,99,7,11,Joe Hughes,19,Xavier,4,6,18,2011,2008
593,9,0,CAA,11,8,6,14,2,6,20,1,2,13,105,11,7,Travis Ingram,19,Towson,2,4,22,2018,2018
594,3,0,Ivy,6,6,5,7,1,7,14,6,8,13,51,1,3,Konrad Kiszka,19,Princeton,2,3,7,2020,2020
595,1,0,A-10,14,7,7,19,0,0,19,5,9,14,105,15,13,Ivan Kovacevic,19,St. Bonaventure,2,4,29,2007,2007
596,0,0,Southern,9,7,7,12,0,1,13,5,6,17,45,7,4,Gene Langan,19,Furman,0,3,16,2016,2015
597,1,0,Patriot,12,7,5,15,2,5,20,3,8,17,94,5,13,Sekou Lewis,19,American,0,4,17,2007,2007
598,1,0,Ivy,14,5,3,9,2,7,16,7,11,20,65,0,6,Chaz Mack,19,Cornell,0,6,14,2020,2019
599,18,1,MAC,5,7,6,16,1,8,24,4,10,26,142,1,9,Kaleb Mallory,19,Ball State,6,9,6,2017,2014
600,10,0,Summit,12,7,3,15,4,8,23,1,2,17,109,0,5,Dezmond McDaniel,19,Oral Roberts,3,3,12,2017,2017
601,23,1,Southland,11,5,4,8,1,4,12,8,20,15,138,1,14,Jarrod McDaniel,19,Stephen F. Austin,7,9,12,2009,2009
602,0,1,Total,5,6,6,9,0,0,9,7,13,11,51,10,8,Geremy McKay,19,Total,1,2,15,2017,2015
603,28,0,MEAC,18,5,4,16,1,1,17,8,16,42,282,8,32,Imani Miller,19,Hampton,11,20,26,2017,2016
604,1,0,Southland,5,6,5,10,1,9,19,6,8,11,77,5,13,Jon Miller,19,Texas-Arlington,4,6,10,2010,2009
605,3,0,Southland,8,5,0,5,5,14,19,4,4,22,79,6,6,Andrija Milovanovic,19,McNeese State,0,2,14,2016,2014
606,3,1,MWC,16,5,4,7,1,2,9,8,12,21,80,7,8,Isaac Monson,19,Air Force,0,6,23,2020,2019
607,3,0,CUSA,5,7,3,4,4,8,12,1,2,29,49,1,6,Karl Moton,19,Alabama-Birmingham,1,1,6,2014,2010
608,6,0,SWAC,3,6,2,3,4,13,16,3,4,16,98,2,7,Derrius Nelson,19,Arkansas-Pine Bluff,1,7,5,2012,2012
609,12,0,Big Sky,10,7,5,14,2,8,22,3,5,21,100,2,1,Josh Noble,19,Weber State,2,7,12,2010,2010
610,3,0,OVC,8,5,3,17,2,6,23,7,10,18,148,6,16,Levi Noel,19,Eastern Illinois,3,10,14,2011,2011
611,3,2,SWAC,19,7,7,17,0,4,21,5,10,36,225,8,29,Brandon Powell,19,Alabama A&M,11,9,27,2020,2019
612,1,1,SWAC,11,7,7,26,0,0,26,5,18,15,175,11,40,Emmenle Preston,19,Mississippi Valley State,4,16,22,2009,2009
613,2,2,ACC,9,9,9,15,0,1,16,1,4,21,56,9,10,Harrison Prieto,19,Florida State,1,4,18,2020,2018
614,0,0,ACC,2,6,1,1,5,7,8,2,2,13,25,1,1,Jacob Redding,19,Louisville,0,0,3,2019,2018
615,4,0,NEC,8,5,5,10,0,1,11,9,16,14,55,1,9,Guyvans Richard,19,Mount St. Mary's,1,16,9,2007,2007
616,1,0,Southland,7,7,5,11,2,5,16,3,5,13,43,2,6,Anthony Robinson,19,McNeese State,4,4,9,2008,2008
617,1,2,Pac-12,23,8,8,21,0,0,21,3,8,17,122,13,38,Austin Seferian-Jenkins,19,Washington,3,1,36,2012,2012
618,12,0,Big 12,6,7,4,11,3,15,26,2,4,45,95,2,10,Tyler Self,19,Kansas,1,20,8,2017,2013
619,3,5,Big South,8,7,7,14,0,4,18,5,8,25,70,2,16,Josh Seligson,19,North Carolina-Asheville,7,9,10,2013,2011
620,4,1,Ivy,10,7,4,7,3,11,18,2,4,19,59,3,5,Jake Shaper,19,Brown,2,7,13,2020,2018
621,5,0,Southern,9,7,2,2,5,19,21,0,0,19,107,2,3,Adam Sheehan,19,Wofford,3,3,11,2007,2007
622,0,6,CUSA,14,8,8,17,0,0,17,3,12,14,81,7,28,Matt Simpkins,19,Memphis,5,6,21,2009,2009
623,6,1,Big East,5,5,4,10,1,2,12,8,15,19,85,6,13,Darius Smith,19,Connecticut,4,9,11,2010,2010
624,9,1,A-10,6,8,7,13,1,7,20,2,5,23,147,5,15,Greg Smith,19,Saint Joseph's,1,3,11,2020,2019
625,1,3,Southland,10,8,8,20,0,0,20,3,8,17,45,6,7,JaQuan Smith,19,Stephen F. Austin,2,3,16,2016,2016
626,6,11,Big West,23,6,5,17,1,2,19,6,12,16,128,8,23,Jermaine Smith,19,Cal State Northridge,2,9,31,2009,2009
627,4,1,Big Sky,2,6,2,5,4,19,24,3,6,26,76,1,11,Trevor Spoja,19,Montana,0,4,3,2018,2017
628,5,3,MAC,9,8,7,10,1,7,17,2,6,15,87,3,5,Daivon Stephens,19,Eastern Michigan,4,7,12,2019,2019
629,13,6,MEAC,30,4,4,16,0,6,22,11,23,26,194,20,38,Maurice Taylor,19,North Carolina A&T,7,23,50,2014,2014
630,10,5,MEAC,15,7,7,23,0,13,36,5,9,25,218,12,20,Anthony Thomas,19,Howard,3,26,27,2008,2008
631,3,2,Patriot,9,8,7,13,1,3,16,2,5,15,84,6,16,Alex Timmerman,19,Bucknell,3,6,15,2020,2020
632,1,1,Big West,5,7,4,6,3,9,15,2,3,6,43,3,4,Rashard Todd,19,Cal State Fullerton,3,2,8,2016,2016
633,5,1,WAC,22,6,6,15,0,0,15,7,8,48,153,9,26,Garrett Ton,19,San Jose State,5,4,31,2012,2009
634,10,0,WAC,3,5,4,12,1,3,15,8,10,12,76,1,9,Nathan Townsen Jr.,19,Chicago State,4,12,4,2018,2018
635,17,0,WAC,8,7,7,19,0,1,20,5,12,28,123,8,14,David Trimble,19,Seattle,4,10,16,2014,2013
636,11,1,Total,15,5,0,5,5,16,21,4,7,42,147,0,12,Tyler Underwood,19,Total,6,8,15,2020,2017
637,1,1,Big Ten,5,6,3,7,3,5,12,4,7,26,45,3,5,Travis Valmon,19,Maryland,2,6,8,2020,2017
638,0,2,Total,8,7,5,13,2,6,19,3,4,29,71,3,9,Blake Vedder,19,Total,1,3,11,2015,2011
639,4,0,OVC,5,5,4,6,1,5,11,8,14,20,70,2,5,Cody Waddey,19,Tennessee State,5,7,7,2007,2007
640,12,0,OVC,4,7,2,4,5,13,17,0,1,27,84,1,8,Zac Walker,19,Tennessee Tech,6,8,5,2009,2007
641,7,0,SWAC,4,6,5,19,1,12,31,6,12,18,104,10,18,Shawn Willett,19,Alcorn State,4,10,14,2016,2016
642,0,1,Southern,3,5,3,3,2,3,6,7,7,11,25,1,0,Aaron Williams,19,Western Carolina,0,3,4,2016,2015
643,5,1,A-10,5,6,3,8,3,10,18,4,8,6,78,5,11,James Williams,19,St. Bonaventure,3,6,10,2007,2007
644,5,5,OVC,11,8,8,23,0,0,23,3,9,12,111,8,23,Zack Winston,19,Jacksonville State,4,7,19,2008,2008
645,1,4,SEC,16,8,8,13,0,0,13,3,5,23,97,11,19,Tai Wynyard,19,Kentucky,4,5,27,2018,2017
646,1,2,Southland,6,6,6,15,0,0,15,6,8,23,65,9,7,Dustin Adams,18,Northwestern State,0,3,15,2014,2013
647,2,1,Big East,5,8,8,14,0,0,14,2,4,29,53,6,6,Tim Andree,18,Notre Dame,2,3,11,2010,2007
648,5,0,Big East,5,7,5,8,2,15,23,2,2,16,87,1,14,Bryan Antoine,18,Villanova,3,2,6,2020,2020
649,9,0,Big Sky,3,5,4,13,1,7,20,7,8,18,114,1,16,Dato Aphkhazava,18,Southern Utah,4,10,4,2019,2019
650,2,0,Southern,7,5,2,5,3,12,17,5,6,31,71,3,9,J.R. Archer,18,Appalachian State,0,5,10,2011,2008
651,2,0,MEAC,5,5,0,4,5,14,18,3,4,16,84,4,8,Derrick Banks,18,Morgan State,2,9,9,2012,2011
652,5,2,SWAC,18,7,7,19,0,2,21,4,6,22,182,10,26,Omar Beauperthuy,18,Alcorn State,0,11,28,2015,2015
653,5,0,Big 12,7,6,3,6,3,12,18,3,8,35,63,1,10,Brennan Bechard,18,Kansas,0,0,8,2009,2007
654,2,1,WAC,6,8,7,17,1,4,21,1,4,17,57,3,4,Travis Blackstock,18,Idaho,1,1,9,2010,2009
655,1,4,MAAC,11,9,9,20,0,0,20,0,3,22,100,12,16,Tyrel Bladen,18,Rider,0,9,23,2020,2020
656,1,0,MVC,3,7,7,9,0,0,9,4,6,14,48,4,9,Ryan Bradley,18,Wichita State,0,4,7,2007,2007
657,0,0,WCC,3,6,0,2,6,15,17,0,0,14,37,1,1,Richard Branning,18,Pepperdine,0,2,4,2012,2009
658,7,0,Big Ten,7,6,3,9,3,10,19,3,6,39,67,3,3,Tanner Bronson,18,Wisconsin,7,5,10,2008,2007
659,12,0,MAC,11,7,5,14,2,11,25,2,3,13,114,1,15,Michael Brown,18,Ohio,9,10,12,2020,2020
660,1,1,NEC,8,9,9,21,0,0,21,0,4,15,96,9,22,Kirk Bunn,18,Mount St. Mary's,4,10,17,2007,2007
661,16,0,A-10,15,4,3,23,1,7,30,9,17,60,173,5,15,Torey Burston,18,Virginia Commonwealth,8,6,20,2017,2014
662,1,2,Big East,13,8,7,12,1,1,13,1,4,26,65,5,21,Matt Cajuste,18,Seton Hall,2,4,18,2010,2009
663,2,1,AAC,5,6,6,12,0,8,20,6,9,18,89,6,13,Jamir Chaplin,18,South Florida,2,3,11,2020,2020
664,1,1,MEAC,5,7,7,19,0,1,20,4,8,12,95,6,9,Novian Cherry,18,Savannah State,2,10,11,2016,2016
665,4,0,A-10,3,5,2,4,3,13,17,5,6,33,56,0,4,Kyle Church,18,Charlotte,0,6,3,2010,2007
666,13,0,Total,13,7,5,17,2,13,30,2,4,39,136,8,15,Bill Clark,18,Loyola (IL),3,12,21,2014,2012
667,2,1,OVC,4,6,5,8,1,2,10,5,6,9,32,2,2,Ben Congiusta,18,Tennessee-Martin,2,4,6,2009,2009
668,21,0,Patriot,16,7,6,17,1,13,30,3,4,55,232,3,32,Ted Connolly,18,Navy,14,17,19,2012,2009
669,6,0,ACC,7,7,5,10,2,9,19,2,4,35,58,0,8,Patrick Crouch,18,North Carolina,1,12,7,2012,2011
670,1,1,Big 12,3,7,4,5,3,10,15,1,2,28,94,1,3,Mark Currie,18,Iowa State,1,2,4,2008,2007
671,6,2,Southern,26,8,8,24,0,0,24,2,6,26,151,11,13,Chris Daniels,18,Georgia Southern,4,16,37,2013,2013
672,4,0,CAA,3,5,0,1,5,10,11,3,5,11,38,0,5,Kevin Doi,18,Drexel,1,5,3,2019,2018
673,1,2,Ivy,13,6,4,8,2,6,14,4,4,14,58,5,8,Balsa Dragovic,18,Harvard,0,5,18,2019,2016
674,7,0,Big Ten,14,5,5,9,0,7,16,8,10,23,112,4,11,DeMarcus Ducre,18,Michigan State,2,12,18,2007,2007
675,0,2,Patriot,8,7,7,9,0,0,9,4,16,38,115,6,21,Josh Forney,18,Loyola (MD),5,10,14,2016,2014
676,2,4,MVC,13,6,6,13,0,0,13,6,7,27,163,8,34,Jamaal Foster,18,Southern Illinois,2,7,21,2007,2007
677,1,1,Summit,3,5,5,12,0,6,18,8,11,11,86,1,2,Trevor Franklin,18,Missouri-Kansas City,0,4,4,2013,2013
678,0,4,Summit,11,6,6,14,0,0,14,6,14,15,82,4,19,Giovanni Fraser,18,IUPUI,0,6,15,2017,2017
679,0,1,Big Sky,11,6,4,5,2,4,9,4,5,11,51,4,7,Josh Fuller,18,Weber State,1,4,15,2014,2014
680,9,0,Patriot,4,7,4,6,3,9,15,1,2,32,70,1,3,Cory Goodman,18,Lehigh,2,5,5,2013,2011
681,0,0,Big Sky,5,6,0,0,6,13,13,0,0,8,20,0,3,Roy Grigsby,18,Northern Colorado,0,0,5,2020,2020
682,6,0,GWC,3,7,6,9,1,5,14,3,6,8,64,4,5,"Dwayne ""DJ"" Gutridge",18,Texas-Rio Grande Valley,2,6,7,2011,2011
683,2,0,OVC,3,6,3,10,3,14,24,3,4,16,74,0,8,James Harris,18,Austin Peay,5,6,3,2009,2009
684,3,2,CUSA,10,9,9,14,0,0,14,0,0,14,81,1,11,Herb Harrison,18,Alabama-Birmingham,2,7,11,2012,2012
685,9,0,WCC,25,7,7,11,0,6,17,4,11,29,226,11,23,Kevin Hempy,18,Pepperdine,4,3,36,2018,2017
686,5,0,OVC,5,6,3,11,3,8,19,3,6,9,83,5,4,Charles Henderson Jr,18,Tennessee-Martin,2,4,10,2019,2019
687,5,0,ACC,5,6,4,11,2,12,23,4,4,27,58,0,8,Jay Henderson,18,Louisville,5,2,5,2017,2016
688,5,0,Total,7,7,4,8,3,15,23,1,4,24,68,1,8,Elijah Holifield,18,Total,4,3,8,2019,2016
689,0,1,SWAC,10,5,4,12,1,4,16,7,9,15,65,6,5,Gregory Holloway,18,Mississippi Valley State,0,4,16,2019,2019
690,5,0,Southern,5,6,5,8,1,5,13,5,6,10,35,4,5,Andrew Houts,18,Chattanooga,2,5,9,2014,2014
691,3,4,SWAC,6,7,7,10,0,0,10,4,13,12,36,3,9,Tony Jacob,18,Alabama State,1,8,9,2015,2014
692,3,3,Southland,13,5,5,13,0,0,13,8,12,26,187,11,49,Jamaal James,18,Southeastern Louisiana,2,10,24,2013,2013
693,9,0,Big Sky,9,6,4,4,2,7,11,4,9,26,109,3,12,Xzaivier James,18,Northern Colorado,4,9,12,2014,2011
694,6,0,AEC,1,6,1,4,5,15,19,1,2,14,98,1,9,Garrett Jones,18,New Hampshire,1,6,2,2013,2012
695,5,2,MVC,10,6,3,8,3,8,16,3,4,23,83,2,4,Samm Jones,18,Drake,3,2,12,2020,2018
696,1,1,Southland,4,5,3,6,2,5,11,6,14,10,33,5,7,Tyquon Jordan,18,Houston Baptist,1,4,9,2018,2017
697,6,0,NEC,5,8,7,10,1,7,17,1,2,31,69,1,3,Kurt Joseph,18,Long Island University,3,13,6,2012,2010
698,4,0,Ind,8,6,3,7,3,4,11,3,6,13,92,2,7,Cody Kale,18,Cal State Bakersfield,1,4,10,2011,2011
699,8,1,Big East,13,6,2,7,4,12,19,2,4,29,167,5,20,Ryan Kardok,18,South Florida,6,7,18,2010,2009
700,5,1,Summit,4,7,6,10,1,5,15,3,6,23,72,2,4,John Kast,18,Oakland,0,13,6,2010,2008
701,11,1,Total,8,8,6,15,2,14,29,0,2,15,149,3,11,Martavis Kee,18,Total,9,11,11,2011,2008
702,1,1,NEC,14,5,1,4,4,14,18,4,4,28,76,2,7,Michael Klebon,18,Saint Francis (PA),1,4,16,2019,2016
703,1,0,SEC,14,8,8,18,0,1,19,2,7,11,86,8,15,Ousmane Konate,18,South Carolina,1,11,22,2007,2007
704,4,7,Big Sky,12,8,8,13,0,0,13,2,7,21,126,7,19,Kelby Kramer,18,Montana,2,7,19,2019,2019
705,9,2,A-10,18,7,7,18,0,3,21,4,4,19,134,9,24,David Kristensen,18,Davidson,3,9,27,2020,2020
706,1,4,MAC,5,7,6,12,1,5,17,3,4,6,50,4,3,Justin Lee,18,Northern Illinois,0,3,9,2020,2020
707,0,1,Big Sky,10,8,8,20,0,0,20,2,4,12,78,9,15,Dani Lopez,18,Sacramento State,1,10,19,2010,2010
708,19,2,Big East,23,7,7,23,0,6,29,4,9,21,178,3,25,Oscar Lopez,18,DePaul,2,22,26,2020,2020
709,12,5,A-Sun,18,5,5,20,0,8,28,8,10,21,142,11,19,Charlie Lytle,18,Florida Gulf Coast,2,15,29,2011,2011
710,13,2,Patriot,11,8,7,11,1,1,12,1,4,18,212,12,37,Nick Macarchuk,18,American,8,10,23,2018,2018
711,0,0,A-Sun,7,6,0,3,6,12,15,0,0,10,49,1,4,Caleb Matthews,18,NJIT,0,5,8,2020,2020
712,5,1,OVC,11,7,6,17,1,4,21,3,9,23,107,1,8,Acoydan McCarthy,18,Austin Peay,2,6,12,2018,2018
713,4,1,SEC,10,5,4,7,1,4,11,7,12,33,117,1,7,Kyle McClanahan,18,Florida,4,7,11,2011,2009
714,19,0,Total,7,5,3,12,2,6,18,6,8,46,193,2,24,Blake McDonald,18,Texas A&M,3,12,9,2014,2011
715,2,2,SEC,16,7,7,16,0,0,16,4,11,4,77,5,7,Montrell McDonald,18,Arkansas,2,8,21,2009,2009
716,15,0,Big West,13,6,6,17,0,2,19,6,10,16,118,1,17,Jamel McGuire,18,Cal State Fullerton,5,17,14,2010,2010
717,2,0,SEC,6,5,5,17,0,3,20,8,9,7,59,5,3,Mario McKinney Jr.,18,Missouri,0,4,11,2020,2020
718,1,1,AEC,8,8,8,28,0,8,36,2,2,6,129,4,15,Ian Milne,18,Binghamton,3,6,12,2007,2007
719,4,0,Patriot,12,8,8,15,0,3,18,2,5,17,112,7,12,Ryan Moffatt,18,Colgate,3,6,19,2020,2020
720,2,0,Sun Belt,2,6,0,0,6,15,15,0,0,8,31,0,1,Evan Moorman,18,Little Rock,1,0,2,2017,2016
721,0,2,WAC,11,6,6,11,0,1,12,6,17,13,95,3,13,Ronnie Morgan,18,Louisiana Tech,1,8,14,2007,2007
722,0,7,Total,9,6,6,22,0,0,22,6,12,34,119,11,20,Bawa Muniru,18,Total,2,5,20,2012,2010
723,3,0,SWAC,2,5,5,17,0,1,18,8,16,17,55,6,16,Cameron Nettles,18,Mississippi Valley State,3,8,8,2009,2009
724,9,0,Patriot,10,6,4,8,2,5,13,4,10,29,126,2,12,Jake Newman,18,Lafayette,0,7,12,2015,2014
725,4,0,Big West,5,6,4,11,2,5,16,4,8,11,67,1,10,Kameron Ng,18,Hawaii,0,10,6,2020,2020
726,4,0,Ivy,10,6,6,12,0,3,15,6,8,15,63,6,12,Leo Nolan,18,Columbia,2,3,16,2007,2007
727,2,0,Total,7,6,6,8,0,1,9,6,11,30,60,1,3,Alex Olsen,18,Creighton,2,1,8,2014,2013
728,5,0,NEC,3,4,1,6,3,8,14,7,8,6,35,3,6,Craig Owens Jr.,18,Long Island University,3,3,6,2019,2019
729,9,0,Southern,16,6,4,13,2,5,18,4,7,29,149,7,13,Matt Panaggio,18,Mercer,4,13,23,2015,2015
730,3,0,Pac-12,7,8,6,10,2,6,16,0,1,19,129,3,3,Kyle Perkins,18,Utah,4,6,10,2012,2012
731,9,1,A-10,8,7,3,8,4,13,21,0,3,20,96,2,15,Frankie Policelli,18,Dayton,2,5,10,2019,2019
732,2,1,Horizon,20,5,5,12,0,0,12,8,14,46,145,4,26,Alex Prahl,18,Milwaukee,0,6,24,2018,2015
733,8,3,Big East,14,7,7,20,0,9,29,4,8,18,100,6,16,Dee Proby,18,West Virginia,5,7,20,2009,2009
734,0,6,AAC,11,6,4,10,2,8,18,4,7,7,56,4,7,Rico Quinton,18,East Carolina,4,5,15,2019,2019
735,2,2,Patriot,11,7,5,23,2,10,33,2,8,22,115,5,14,Damion Rashford,18,Loyola (MD),2,8,16,2014,2014
736,0,0,Southern,1,6,2,8,4,8,16,2,2,8,30,0,8,Myles Rasnick,18,East Tennessee State,0,1,1,2019,2019
737,12,0,Patriot,15,8,6,13,2,3,16,0,2,17,174,1,22,Joey Reilly,18,Holy Cross,3,15,16,2020,2020
738,7,0,AEC,4,4,1,8,3,18,26,7,11,46,172,2,14,Chris Rice,18,Binghamton,0,13,6,2014,2012
739,1,0,ACC,1,6,1,4,5,14,18,1,2,25,46,1,6,Mike Robinson,18,Miami (FL),1,1,2,2018,2016
740,0,0,Horizon,5,6,3,8,3,11,19,3,4,11,80,6,14,Rob Robinson,18,Illinois-Chicago,2,6,11,2012,2012
741,0,1,Summit,6,6,5,14,1,5,19,5,8,13,39,0,1,"Linwood Ross,",18,IUPUI,0,1,6,2014,2014
742,5,0,Ivy,3,7,5,7,2,12,19,2,2,9,54,2,3,Landon Russell,18,Yale,0,2,5,2017,2015
743,6,5,Big 12,13,6,4,12,2,7,19,4,6,36,143,5,20,Cole Salomon,18,Nebraska,1,10,18,2009,2008
744,1,2,Big South,12,5,5,15,0,0,15,8,16,23,141,8,13,Alfonso Scandrett,18,Radford,6,4,20,2007,2007
745,7,0,NEC,21,4,2,8,2,15,23,8,11,22,138,4,14,Kevin Schafer,18,Monmouth,1,12,25,2010,2008
746,0,0,Summit,5,6,2,2,4,10,12,2,2,13,38,1,2,Jake Showalter,18,North Dakota State,0,2,6,2015,2015
747,6,0,Total,7,7,3,7,4,19,26,0,0,11,167,2,14,Evan Smith,18,Southern California,4,13,9,2012,2010
748,2,0,SWAC,9,5,3,4,2,13,17,6,9,16,49,1,6,Kenneth Smith,18,Jackson State,4,3,10,2013,2013
749,1,0,Big East,5,6,0,0,6,21,21,0,0,24,55,0,4,Dalton Soffer,18,Seton Hall,2,1,5,2017,2016
750,7,0,MWC,4,6,5,9,1,9,18,5,8,23,65,0,7,Michael Sohikish,18,San Diego State,4,3,4,2019,2018
751,2,1,Horizon,22,6,6,18,0,0,18,6,13,33,139,13,21,Babatunde Sowunmi,18,Oakland,4,9,35,2020,2019
752,1,0,Mid-Cont,9,5,5,13,0,0,13,8,10,12,49,4,18,Sylvester Spicer,18,Oral Roberts,1,6,13,2007,2007
753,2,0,ACC,3,6,0,0,6,15,15,0,0,19,44,0,3,Anthony Starzynski,18,Pittsburgh,2,2,3,2020,2018
754,1,1,SWAC,16,8,8,21,0,0,21,2,3,16,116,7,24,Mike Stone,18,Alabama State,1,12,23,2020,2020
755,12,0,MVC,10,6,2,4,4,14,18,2,2,53,130,0,9,Taylor Stormberg,18,Creighton,4,7,10,2013,2011
756,6,1,MVC,2,6,2,4,4,13,17,2,4,20,69,0,4,Devan Straub,18,Evansville,2,1,2,2020,2019
757,3,3,AEC,21,6,1,12,5,14,26,1,2,27,214,7,25,Brendan Sullivan,18,Boston University,4,8,28,2010,2009
758,0,3,Ivy,5,6,6,11,0,0,11,6,7,12,49,7,11,Peter Swiatek,18,Harvard,0,3,12,2009,2009
759,1,2,MEAC,6,9,9,16,0,1,17,0,0,22,85,5,12,Bakari Taylor,18,Hampton,2,2,11,2012,2010
760,0,3,MAC,5,8,8,10,0,0,10,2,2,9,60,2,8,Zac Taylor,18,Toledo,1,7,7,2009,2009
761,2,0,WAC,9,9,9,20,0,0,20,0,3,17,58,6,8,Londale Theus,18,New Mexico State,1,6,15,2008,2007
762,3,1,A-Sun,4,7,5,12,2,8,20,2,2,6,48,1,7,Chad Thompson,18,Campbell,1,3,5,2009,2009
763,1,0,A-10,4,6,3,4,3,13,17,3,6,13,42,1,2,Jean Yves Toupane,18,St. Bonaventure,2,1,5,2014,2013
764,2,5,Big Sky,16,9,9,13,0,2,15,0,5,18,92,8,10,Dave Vanerjagt,18,Montana,3,6,24,2008,2007
765,4,1,WAC,16,6,5,16,1,2,18,5,7,27,99,4,13,Alex Veit,18,Hawaii,0,8,20,2008,2007
766,0,11,Pac-10,22,8,8,19,0,0,19,2,12,24,158,7,23,Kirk Walters,18,Arizona,3,7,29,2008,2007
767,0,4,MEAC,5,7,7,17,0,0,17,4,8,10,93,11,19,Joshu'a Warren,18,Maryland-Eastern Shore,4,12,16,2016,2016
768,1,0,MAC,4,6,2,7,4,14,21,2,3,14,43,0,3,Stacey Waters,18,Ohio,0,4,4,2009,2009
769,15,0,Horizon,7,5,2,9,3,17,26,5,9,26,157,1,5,Marcus White,18,Illinois-Chicago,7,5,8,2015,2014
770,6,0,Big 12,3,7,3,7,4,13,20,0,0,5,45,3,4,Shaun Williams,18,Kansas State,2,8,6,2020,2020
771,0,3,Southern,16,6,6,23,0,0,23,6,13,14,93,14,17,Tommy Williams,18,East Tennessee State,2,7,30,2015,2015
772,2,0,WAC,15,7,5,9,2,5,14,2,7,30,89,5,16,Jerelle Wilson,18,San Jose State,3,6,20,2010,2007
773,6,0,CUSA,8,6,5,10,1,4,14,5,6,14,81,3,2,Larry Wise,18,North Texas,3,7,11,2020,2020
774,2,0,ACC,12,8,8,17,0,1,18,2,6,36,34,6,3,Surry Wood,18,North Carolina,1,4,18,2008,2007
775,15,3,Patriot,13,7,7,17,0,11,28,4,4,13,162,1,16,Lincoln Yeutter,18,Holy Cross,5,15,14,2020,2019
776,4,0,OVC,8,7,4,12,3,12,24,0,1,20,68,2,4,Mohamed Abuarisha,17,Jacksonville State,1,9,10,2018,2017
777,1,2,Southland,21,7,7,16,0,0,16,3,9,17,120,8,21,Deji Adekunle,17,Northwestern State,1,11,29,2015,2015
778,1,2,SWAC,15,7,7,11,0,0,11,3,10,29,133,5,35,Marvin Adu,17,Prairie View,5,8,20,2012,2011
779,0,2,MVC,17,5,5,10,0,0,10,7,11,12,70,6,19,Christopher Agbo,17,Indiana State,1,8,23,2020,2020
780,2,0,Big South,5,4,2,2,2,9,11,7,10,30,49,2,4,Tyler Akers,17,Longwood,0,4,7,2015,2014
781,0,0,NEC,2,5,1,5,4,9,14,3,4,8,30,0,3,Marlon Alcindor,17,St. Francis (NY),0,1,2,2016,2016
782,7,1,Big 12,5,7,7,13,0,0,13,3,6,21,47,2,9,Tyrone Appleton,17,Kansas,1,9,7,2009,2009
783,1,2,A-Sun,14,8,8,24,0,1,25,1,5,30,121,15,14,Larry Awosanya,17,Campbell,2,8,29,2011,2010
784,3,3,WCC,14,7,7,20,0,5,25,3,8,22,91,8,9,Khalil Bedart-Ghani,17,San Diego,7,8,22,2016,2015
785,5,0,A-10,4,6,3,12,3,11,23,2,6,19,92,0,7,David Boykin,17,Fordham,2,7,4,2007,2007
786,9,0,MEAC,5,6,2,5,4,15,20,1,3,13,64,1,11,Demetrius Branch,17,Morgan State,2,8,6,2007,2007
787,1,0,CUSA,1,7,6,11,1,2,13,2,7,5,28,0,1,Kevin Branch,17,Southern Mississippi,4,3,1,2008,2008
788,1,0,Big Sky,2,5,1,5,4,8,13,3,4,15,33,3,3,Freddy Brown III,17,Montana,0,2,5,2019,2019
789,4,1,NEC,10,6,6,15,0,2,17,5,8,11,86,4,4,Ronald Brown,17,Fairleigh Dickinson,5,14,14,2008,2008
790,0,3,SWAC,6,6,6,9,0,0,9,5,11,13,53,3,9,Tremere Brown,17,Alabama A&M,0,6,9,2020,2020
791,7,1,A-Sun,17,7,5,21,2,9,30,1,3,19,120,4,12,Josh Burnett,17,Kennesaw State,6,10,21,2017,2016
792,2,0,SEC,0,7,6,10,1,7,17,2,5,20,59,5,3,Greg Cage,17,Alabama,1,5,5,2010,2007
793,5,2,ACC,31,8,7,18,1,4,22,0,3,47,240,13,28,John Cain Carney,17,Boston College,6,8,44,2015,2012
794,2,0,Big 12,11,6,4,12,2,9,21,3,4,9,61,5,9,Kyle Cannon,17,Oklahoma,1,2,16,2009,2009
795,4,0,Big South,0,6,4,7,2,7,14,3,5,9,70,0,11,JC Cavin,17,Charleston Southern,2,3,0,2018,2018
796,2,1,WCC,2,6,2,7,4,10,17,1,5,18,55,4,5,Kelsey Chine,17,Loyola Marymount,2,3,6,2012,2010
797,2,0,Southland,5,6,4,8,2,5,13,3,3,12,51,0,6,Robert Chougkaz,17,Northwestern State,0,6,5,2020,2020
798,1,3,CUSA,5,5,0,1,5,16,17,2,3,10,56,0,8,Kasper Christensen,17,Florida International,3,1,5,2018,2018
799,12,0,Southern,6,7,4,9,3,15,24,0,0,41,116,2,6,Can Civi,17,Davidson,3,17,8,2009,2007
800,4,0,Southland,4,6,3,4,3,13,17,2,4,24,66,2,7,Chase Cobb,17,Abilene Christian,3,7,6,2019,2018
801,2,1,Big South,2,7,6,9,1,1,10,2,2,4,28,3,1,Matt Day,17,North Carolina-Asheville,0,3,5,2007,2007
802,2,1,SWAC,16,8,8,26,0,6,32,1,2,22,114,10,14,Kenny Demouchet,17,Jackson State,4,10,26,2013,2013
803,1,0,Big Sky,4,7,7,11,0,0,11,3,6,17,44,5,7,Travis Derochowski,17,Montana State,0,1,9,2007,2007
804,1,2,SWAC,8,5,5,10,0,0,10,7,11,21,68,6,7,Michael Dobbins,17,Texas Southern,2,5,14,2019,2019
805,6,0,Ivy,5,5,2,2,3,16,18,4,6,23,81,3,5,A.J. Edwards,17,Yale,1,4,8,2016,2014
806,4,0,Sun Belt,3,4,1,4,3,5,9,6,10,32,67,1,11,Devin Epps,17,South Alabama,3,6,4,2018,2015
807,1,0,MVC,5,6,1,3,5,15,18,0,0,24,45,1,3,Ross Ferrarini,17,Creighton,2,3,6,2012,2011
808,2,1,WAC,10,5,4,20,1,4,24,6,14,20,78,4,13,Kevin Fleming,17,San Jose State,2,7,14,2008,2008
809,6,1,Total,11,3,0,6,3,11,17,8,8,29,103,0,9,Philip Flory,17,Total,0,6,11,2019,2018
810,2,2,CAA,13,8,8,19,0,0,19,1,7,20,107,8,14,Sajon Ford,17,Northeastern,6,9,21,2017,2016
811,4,0,AEC,2,7,6,11,1,7,18,2,4,29,44,3,7,Nick Fruscio,17,Albany (NY),1,3,5,2020,2017
812,3,0,Big East,3,6,1,4,5,12,16,0,0,24,35,1,1,Tim Frye,17,Pittsburgh,1,6,4,2010,2008
813,1,1,Ivy,3,7,7,8,0,1,9,3,4,9,28,1,4,Noah Gear,17,Cornell,0,1,4,2020,2020
814,5,1,Big West,6,5,3,3,2,10,13,5,9,13,89,3,8,Roberto Gittens,17,UC-Santa Barbara,0,1,9,2020,2020
815,1,0,Big Sky,1,5,5,10,0,0,10,7,11,7,38,2,4,Brandon Glanz,17,Idaho State,0,2,3,2012,2012
816,2,0,AEC,6,5,3,11,2,5,16,5,7,12,54,0,4,Tre Green,17,Albany (NY),3,6,6,2015,2015
817,5,0,Total,6,5,0,0,5,15,15,2,4,30,65,0,11,Corey Haith,17,Total,4,6,6,2017,2013
818,1,1,MWC,12,5,5,12,0,0,12,7,12,16,73,7,13,Darrious Hamilton,17,Boise State,3,8,19,2013,2013
819,1,0,CAA,2,7,4,8,3,8,16,0,0,6,27,1,1,Nigel Haughton,17,Towson,1,1,3,2020,2020
820,7,1,Big Sky,13,6,2,3,4,21,24,1,2,18,119,0,11,Zach Hobbs,17,Montana State,4,9,13,2020,2020
821,7,0,Big Ten,10,5,2,4,3,15,19,4,7,14,97,1,11,Steve Holdren,17,Illinois,2,2,11,2008,2008
822,0,1,Southland,2,5,1,3,4,7,10,3,4,8,21,0,0,Lionell Holmes,17,Stephen F. Austin,0,2,2,2010,2010
823,1,0,Big Sky,8,6,2,3,4,8,11,1,2,12,55,4,4,Nick Huston,17,Idaho State,1,0,12,2020,2020
824,3,4,SWAC,12,7,7,12,0,6,18,3,12,15,101,10,23,Quintarius Hutchinson,17,Total,2,12,22,2012,2011
825,1,3,Southern,13,7,7,12,0,0,12,3,10,29,115,9,42,Emeka Ikezu,17,Samford,2,9,22,2015,2014
826,9,0,Big Ten,10,6,6,12,0,2,14,5,12,20,116,2,10,Pat Ingram,17,Iowa,3,9,12,2013,2013
827,6,6,Summit,16,5,5,10,0,6,16,7,13,19,87,5,20,Josh Inkumsah,17,Purdue-Fort Wayne,4,5,21,2020,2019
828,4,1,Total,12,7,4,13,3,9,22,0,0,13,98,1,7,Mark Jackson,17,Total,3,10,13,2013,2012
829,0,0,A-Sun,7,6,6,19,0,0,19,5,7,5,42,6,4,Michael Jenkins,17,Mercer,0,2,13,2010,2010
830,1,2,MAAC,18,5,5,16,0,1,17,7,14,16,104,11,13,Ja'Kwan Jones,17,Quinnipiac,3,5,29,2017,2017
831,1,1,WAC,4,7,7,13,0,1,14,3,6,3,57,5,11,Marlon Jones,17,New Mexico State,0,4,9,2017,2017
832,0,0,Big South,7,7,4,5,3,4,9,0,0,17,48,3,6,Miles Jones,17,Radford,1,2,10,2020,2020
833,7,3,Patriot,20,6,5,13,1,6,19,4,9,26,152,8,31,Kieffer Jordan,17,Army,1,7,28,2015,2014
834,0,0,Southland,5,6,1,2,5,11,13,0,0,12,30,0,4,Derrell Joubert,17,McNeese State,1,2,5,2016,2015
835,3,0,Big West,4,7,4,6,3,7,13,0,0,11,51,3,5,Landon Kirkwood,17,Cal State Fullerton,2,2,7,2018,2018
836,4,1,CUSA,15,7,5,10,2,25,35,1,2,20,170,3,9,John Kitoko,17,Charlotte,3,7,18,2019,2019
837,6,0,CAA,3,7,4,9,3,5,14,0,4,27,68,8,3,Connor Klementowicz,17,Hofstra,1,3,11,2020,2017
838,0,0,ACC,1,5,0,0,5,18,18,2,2,19,32,0,0,Travis Light,17,Florida State,1,0,1,2020,2018
839,2,0,Big West,7,7,7,13,0,0,13,3,5,11,57,5,5,Eddie Lima,17,Cal State Fullerton,3,5,12,2008,2008
840,12,1,MAAC,7,6,4,19,2,11,30,3,5,19,168,7,12,Jeremiah Livingston,17,Saint Peter's,9,12,14,2018,2018
841,3,0,CAA,0,6,3,5,3,12,17,2,6,29,30,0,4,Samer Madarani,17,Delaware,1,3,0,2012,2009
842,3,0,A-Sun,5,7,4,6,3,11,17,0,0,33,79,2,10,Dolan Mahoney,17,Florida Gulf Coast,3,3,7,2019,2016
843,9,0,Southland,6,6,4,11,2,8,19,3,6,9,87,1,9,Timothy Maiden,17,Texas-San Antonio,3,11,7,2007,2007
844,2,0,OVC,4,5,2,9,3,9,18,4,6,18,36,0,2,Jeff Martin,17,Murray State,1,3,4,2015,2014
845,10,1,Sun Belt,6,5,1,3,4,18,21,3,5,21,134,1,17,Todd Martin,17,South Alabama,3,7,7,2011,2011
846,11,0,Southland,4,4,1,2,3,10,12,6,7,25,64,1,3,Kyle McLeroy,17,Sam Houston State,1,7,5,2015,2014
847,13,1,Big Ten,15,6,6,22,0,0,22,5,19,27,180,7,27,Souf Mensah,17,Rutgers,4,17,22,2018,2018
848,4,0,Horizon,3,6,2,4,4,6,10,1,1,7,45,1,4,Jiovanni Miles,17,Green Bay,1,0,4,2020,2020
849,4,0,Sun Belt,8,7,6,15,1,2,17,2,3,11,64,5,6,Raed Mostafa,17,Western Kentucky,3,3,13,2007,2007
850,1,3,MAAC,13,8,8,16,0,0,16,1,5,21,99,8,15,Greg Noel,17,Niagara,0,4,21,2007,2007
851,1,0,Sun Belt,9,6,1,4,5,17,21,0,1,15,95,4,10,Kinley Ogbonnaya-Branch,17,Arkansas State,1,9,13,2012,2012
852,3,0,WAC,13,8,8,17,0,0,17,1,4,16,91,4,24,Keith Olson,17,Nevada,1,2,17,2010,2010
853,18,0,Big Ten,28,4,2,15,2,3,18,7,14,25,267,10,39,Mike Peltz,17,Nebraska,2,16,38,2014,2013
854,1,1,Big East,7,6,6,15,0,0,15,5,13,41,78,10,11,Tom Planek,17,Providence,5,8,17,2018,2015
855,1,1,AEC,7,2,2,7,0,0,7,13,23,38,81,3,11,Mark Plousis,17,Hartford,2,4,10,2018,2015
856,3,6,CUSA,20,6,6,15,0,0,15,5,11,28,155,9,37,Nate Pollard,17,Rice,2,17,29,2016,2015
857,2,1,CUSA,9,6,1,4,5,17,21,0,0,10,66,1,7,Thaddeus Rideau,17,Alabama-Birmingham,3,2,10,2014,2014
858,2,0,MAC,7,5,1,9,4,12,21,3,7,26,45,7,6,Michael Ritchie,17,Miami (OH),2,5,14,2020,2018
859,3,3,Pac-12,16,5,3,7,2,12,19,5,8,26,81,9,8,Beau Rydalch,17,Utah,1,6,25,2019,2017
860,0,0,Big South,3,6,6,14,0,0,14,5,6,6,45,13,7,Abdul Sarki,17,Charleston Southern,1,3,16,2018,2018
861,4,0,Pac-10,6,6,3,5,3,6,11,2,2,8,50,0,6,Stephen Sauls,17,Washington State,2,4,6,2008,2008
862,0,0,Big Sky,7,5,5,8,0,0,8,7,14,10,49,9,11,Luke Schultz,17,Montana State,2,5,16,2018,2018
863,5,0,Big 12,8,5,3,9,2,14,23,5,8,28,61,3,10,Ryan Schultz,17,Kansas State,5,6,11,2014,2013
864,10,0,Big Ten,6,7,5,14,2,7,21,1,2,41,86,3,7,Kendal Shell,17,Minnesota,3,6,9,2015,2012
865,1,0,Total,3,5,0,1,5,14,15,2,2,16,44,0,6,Bryce Smith,17,Total,2,0,3,2011,2009
866,5,0,SWAC,8,5,3,6,2,3,9,5,6,42,192,7,16,Demetrious Smith,17,Arkansas-Pine Bluff,2,15,15,2013,2011
867,5,0,SWAC,5,5,4,17,1,6,23,6,10,14,89,2,6,Andre' Southern,17,Grambling,2,11,7,2008,2008
868,4,2,A-Sun,23,6,6,14,0,0,14,5,11,25,140,7,31,Sidiki Straub,17,Mercer,6,7,30,2009,2009
869,0,2,Big Ten,13,4,4,15,0,1,16,9,11,23,124,10,16,Joonas Suotamo,17,Penn State,2,11,23,2008,2007
870,0,0,AEC,4,6,1,6,5,16,22,0,0,9,47,3,1,Carlos Taylor,17,Massachusetts-Lowell,0,4,7,2014,2014
871,0,1,WAC,9,6,6,22,0,0,22,5,6,19,161,5,20,Jesse Tesmer,17,Chicago State,3,7,14,2015,2015
872,1,3,WAC,8,7,7,8,0,0,8,3,8,18,95,6,22,Cartrell Thompson,17,Cal State Bakersfield,1,7,14,2019,2019
873,2,0,SWAC,2,6,3,8,3,14,22,2,6,8,69,3,5,Dekedran Thorn,17,Alcorn State,4,4,5,2020,2020
874,0,0,MWC,2,5,0,1,5,15,16,2,2,32,57,4,14,Charlie Tooley,17,Nevada,3,4,6,2018,2017
875,5,1,OVC,12,5,2,3,3,11,14,4,5,6,49,1,3,Jerret Towns,17,Tennessee State,0,4,13,2011,2011
876,1,4,Big South,8,7,7,16,0,1,17,3,16,15,61,8,10,Grant Townsend,17,North Carolina-Asheville,0,6,16,2018,2017
877,2,0,A-Sun,4,7,6,7,1,4,11,2,2,6,31,1,3,Nick Tuggle,17,East Tennessee State,0,3,5,2007,2007
878,4,1,NEC,4,2,2,13,0,2,15,13,21,19,101,0,8,Jonathan Tull,17,Central Connecticut State,3,11,4,2010,2010
879,5,1,CAA,6,6,6,16,0,4,20,5,8,7,116,5,8,Kentrell Washington,17,Hofstra,0,7,11,2013,2013
880,6,1,Big 12,6,5,1,4,4,21,25,3,6,16,86,2,7,Justin Werner,17,Kansas State,3,4,8,2009,2009
881,3,0,Southland,4,4,2,5,2,12,17,7,8,16,44,2,5,Reed Westbrook,17,Stephen F. Austin,2,2,6,2014,2014
882,11,0,Pac-10,7,6,4,15,2,7,22,3,6,33,111,1,8,Ryan Wetherell,17,Southern California,4,7,9,2010,2007
883,2,0,Summit,2,7,4,5,3,6,11,0,0,12,42,0,1,Josh Williams,17,South Dakota,0,2,2,2018,2018
884,3,0,Patriot,4,4,3,5,1,1,6,8,9,18,55,3,8,Milan Williams,17,Colgate,0,1,7,2020,2017
885,6,0,OVC,8,7,4,9,3,12,21,0,2,21,108,3,16,Reggie Williams,17,Morehead State,7,17,11,2011,2011
886,4,0,MWC,2,5,0,0,5,7,7,2,4,10,32,1,0,Kibret Woldemichael,17,San Diego State,1,5,3,2015,2014
887,2,1,OVC,7,6,6,18,0,0,18,5,6,11,65,2,4,Eli York,17,Tennessee-Martin,0,4,9,2012,2012
888,3,5,SEC,6,5,4,10,1,4,14,5,8,6,74,6,11,Shareif Adamu,16,Auburn,3,10,12,2013,2013
889,1,0,MEAC,7,5,4,8,1,10,18,5,6,8,43,2,6,Lamar Adkins,16,Norfolk State,0,8,9,2008,2008
890,9,4,OVC,21,7,5,15,2,4,19,0,3,24,176,13,21,Isaac Aguiar,16,Tennessee-Martin,3,6,34,2020,2020
891,0,1,Sun Belt,6,5,5,9,0,7,16,6,8,11,64,7,9,Eddie Alcantara,16,Western Kentucky,2,9,13,2013,2013
892,3,0,Total,4,5,3,10,2,15,25,4,5,16,59,4,5,Austin Alecxih,16,Total,2,4,8,2012,2010
893,1,3,MEAC,10,8,8,18,0,0,18,0,0,14,80,8,15,McWisdom Badejo,16,Florida A&M,1,0,18,2013,2013
894,0,0,Pac-10,3,5,1,3,4,6,9,2,2,18,28,0,6,David Bagga,16,Arizona,2,3,3,2009,2007
895,2,3,MAC,17,6,5,9,1,16,25,3,4,20,121,10,15,Evan Bainbridge,16,Kent State,5,2,27,2020,2020
896,6,1,MEAC,5,6,4,8,2,7,15,2,3,13,78,3,6,Jeremy Banks,16,Norfolk State,3,7,8,2008,2008
897,5,0,WCC,8,5,1,7,4,16,23,2,4,46,108,3,7,Jack Beach,16,Gonzaga,4,0,11,2019,2016
898,3,1,Southern,2,6,4,9,2,4,13,2,4,20,78,3,13,Andrew Bellebaum,16,Wofford,0,6,5,2008,2007
899,9,0,Big East,22,5,3,11,2,17,28,4,13,10,120,3,10,Dahmir Bishop,16,Xavier,2,7,25,2020,2020
900,3,0,A-Sun,12,7,5,7,2,4,11,0,0,18,37,2,4,Maxx Bleecher,16,Florida Gulf Coast,2,4,14,2017,2016
901,2,0,Big South,7,8,8,17,0,0,17,0,0,9,64,5,9,Trae Brenner,16,Campbell,1,3,12,2013,2013
902,0,2,MVC,6,5,5,11,0,0,11,6,8,5,31,4,4,Blake Brinkmeyer,16,Indiana State,1,1,10,2019,2019
903,2,1,NEC,11,7,5,7,2,15,22,0,3,35,68,4,7,Aaron Brown,16,Mount St. Mary's,2,4,15,2015,2012
904,2,0,Summit,4,5,2,8,3,14,22,3,5,29,57,1,6,Beau Brown,16,South Dakota State,1,1,5,2020,2016
905,3,0,MVC,12,5,1,3,4,13,16,2,2,30,77,1,11,Derek Brown,16,Wichita State,3,3,13,2011,2007
906,2,8,NEC,17,7,7,23,0,0,23,2,14,44,204,13,32,Lawrence Brown,16,Fairleigh Dickinson,0,10,30,2010,2007
907,1,1,Big South,3,7,7,11,0,2,13,2,2,14,32,5,5,Al Burge,16,Longwood,2,2,8,2016,2016
908,14,1,CAA,5,7,6,12,1,8,20,1,4,23,145,0,9,Caleb Burgess,16,Hofstra,8,10,5,2020,2020
909,3,1,NEC,11,6,5,12,1,4,16,3,5,16,78,6,12,David Burton,16,St. Francis (NY),3,9,17,2008,2007
910,13,0,MVC,19,5,3,13,2,13,26,4,11,65,155,3,14,Zach Bush,16,Wichita State,8,8,22,2017,2014
911,1,1,Big Ten,8,7,7,11,0,1,12,2,2,34,54,0,5,Morris Cain,16,Wisconsin,0,2,8,2009,2007
912,20,0,ACC,8,5,2,7,3,12,19,3,4,51,105,1,5,Marc Campbell,16,North Carolina,8,20,9,2010,2008
913,12,0,Big East,6,5,2,6,3,11,17,3,4,21,128,0,10,Jett Canfield,16,Creighton,5,2,6,2020,2020
914,0,1,Big South,2,6,2,9,4,4,13,0,2,11,44,2,1,Mykayle Carter,16,South Carolina Upstate,1,1,4,2020,2020
915,3,0,MEAC,5,5,5,13,0,2,15,6,8,18,59,1,5,Tarik Clement,16,South Carolina State,1,3,6,2018,2017
916,3,0,MAC,8,5,1,3,4,13,16,2,2,37,58,2,7,Drew Crabtree,16,Ohio,1,4,10,2017,2014
917,5,0,SWAC,8,6,4,12,2,13,25,2,2,14,132,3,8,Isiah Cross,16,Alabama A&M,6,5,11,2008,2008
918,1,1,MVC,14,7,7,12,0,0,12,2,6,10,82,6,12,Sekou Dembele,16,Southern Illinois,2,2,20,2020,2020
919,1,1,Total,3,7,7,10,0,0,10,2,3,12,60,12,6,Sooren Derboghosian,16,Total,0,5,15,2015,2013
920,1,2,Big East,4,8,8,15,0,0,15,0,2,9,61,14,15,Cassin Diggs,16,Pittsburgh,0,5,18,2008,2008
921,2,0,Sun Belt,2,6,3,6,3,5,11,1,2,11,23,2,2,Drew Dotson,16,New Orleans,0,3,4,2008,2008
922,4,2,Big Sky,16,7,6,8,1,5,13,1,1,7,73,2,6,Kidus Ephrem,16,Portland State,0,1,18,2012,2012
923,1,1,MAC,8,4,0,7,4,13,20,4,6,14,67,4,7,Dakotah Euton,16,Akron,0,0,12,2011,2011
924,15,0,Big 12,12,4,3,14,1,8,22,7,21,56,104,3,12,T.J. Franklin,16,Oklahoma,2,18,15,2012,2009
925,7,1,Ivy,14,7,7,16,0,0,16,2,7,20,74,9,6,Davis Franks,16,Brown,4,9,23,2020,2019
926,2,0,MVC,9,5,5,12,0,2,14,6,9,6,40,6,10,Sky Frazier,16,Missouri State,0,8,15,2007,2007
927,5,4,MVC,9,7,5,11,2,10,21,0,1,16,105,6,8,Emil Freese-Vilien,16,Valparaiso,1,5,15,2020,2020
928,5,3,CUSA,7,8,8,13,0,1,14,0,2,18,125,5,18,Adam Gill,16,Central Florida,1,9,12,2007,2007
929,2,2,AAC,14,6,6,19,0,4,23,4,6,20,134,8,11,Deantoni Gordon,16,Wichita State,2,4,22,2020,2020
930,6,1,A-10,14,7,5,12,2,9,21,0,1,30,118,5,14,Dominic Green,16,George Washington,2,9,19,2008,2007
931,3,4,Total,18,7,7,13,0,0,13,2,4,31,139,5,7,Beas Hamga,16,Total,1,5,23,2012,2009
932,2,0,Southern,4,6,3,10,3,10,20,1,8,28,78,3,4,Mike Hardiman,16,North Carolina-Greensboro,1,4,7,2010,2007
933,4,0,WAC,3,4,3,5,1,1,6,7,10,10,40,0,1,Mikkel Hauge,16,Seattle,0,3,3,2020,2020
934,0,0,Southland,4,7,7,12,0,1,13,2,5,13,28,5,3,Fred Haywood,16,McNeese State,4,0,9,2018,2018
935,0,3,NEC,4,5,1,3,4,16,19,2,3,19,121,3,14,Troy Henderson,16,Mount St. Mary's,0,4,7,2016,2016
936,1,0,GWC,5,5,1,4,4,7,11,2,2,16,40,1,4,Joe Hill,16,Chicago State,0,3,6,2011,2010
937,2,0,CUSA,6,4,1,6,3,9,15,5,8,26,57,2,4,Charles Holt,16,Memphis,0,5,8,2013,2010
938,6,0,NEC,9,5,2,3,3,16,19,3,4,28,116,4,9,Andrew Hurd,16,Central Connecticut State,4,7,13,2014,2013
939,10,0,CUSA,4,5,2,3,3,6,9,3,6,15,89,0,6,Luis Hurtado,16,Alabama-Birmingham,2,4,4,2020,2019
940,3,3,SEC,13,5,3,9,2,10,19,4,7,21,130,7,18,Oton Jankovic,16,Vanderbilt,4,9,20,2020,2020
941,3,0,MVC,4,5,5,16,0,5,21,6,7,9,51,2,12,Saihou Jassey,16,Bradley,0,1,6,2007,2007
942,6,0,SWAC,6,7,5,14,2,7,21,0,3,45,157,5,24,Larry Johnson,16,Arkansas-Pine Bluff,4,19,11,2016,2015
943,6,0,MEAC,2,6,4,10,2,3,13,2,2,14,38,4,8,Garon Jones,16,Howard,3,5,6,2020,2020
944,1,5,Summit,13,7,7,23,0,0,23,2,5,25,187,7,19,Julian Jones,16,Western Illinois,7,8,20,2009,2009
945,9,0,OVC,11,5,4,7,1,3,10,5,6,14,89,2,7,Noah Kamba,16,Murray State,1,7,13,2020,2020
946,2,0,MEAC,2,5,2,8,3,13,21,3,5,13,48,0,5,Khalid King,16,North Carolina A&T,2,3,2,2013,2013
947,3,2,MAC,10,5,1,8,4,19,27,2,2,14,120,1,5,Lucas Kroft,16,Ball State,2,4,11,2020,2020
948,3,1,Ivy,8,5,5,7,0,0,7,6,10,15,47,5,6,Jake Lanford,16,Yale,1,5,13,2020,2019
949,0,0,Total,2,6,2,3,4,11,14,0,1,20,49,2,2,Isaac Lang,16,Central Florida,0,3,4,2014,2013
950,10,0,Sun Belt,13,4,4,15,0,9,24,8,10,10,136,3,17,Mykhael Lattimore,16,Denver,5,9,16,2007,2007
951,3,1,WCC,9,6,6,14,0,0,14,4,7,16,88,10,15,Nick Loew,16,San Francisco,2,3,19,2018,2015
952,2,2,Ivy,9,5,5,14,0,0,14,6,15,11,78,6,18,Larry Loughery,16,Pennsylvania,3,6,15,2011,2009
953,0,5,Big 12,10,7,7,14,0,0,14,2,5,35,120,4,33,James Love,16,Kansas State,1,3,14,2020,2018
954,10,1,Patriot,24,5,5,9,0,8,17,6,6,27,147,8,14,Mark Madden,16,Army,5,7,32,2020,2018
955,5,0,MAAC,3,6,4,11,2,11,22,2,4,29,66,2,5,Gary Martin,16,Fairfield,3,2,5,2012,2011
956,3,0,MVC,6,5,2,7,3,8,15,3,8,19,82,0,5,Tyeshon Martin,16,Indiana State,2,3,6,2020,2019
957,6,0,CUSA,3,5,3,6,2,13,19,4,7,24,61,3,5,Kyle Massie,16,Texas-San Antonio,0,1,6,2018,2016
958,4,2,Big Ten,6,6,4,9,2,10,19,2,9,19,109,7,6,Kyle McCloskey,16,Penn State,2,4,13,2020,2019
959,2,0,OVC,3,4,2,10,2,7,17,6,9,12,75,1,9,Donald Moore,16,Eastern Illinois,1,6,4,2014,2014
960,2,2,SWAC,16,6,6,24,0,2,26,4,6,24,146,10,23,Mark Moore,16,Prairie View,3,9,26,2007,2007
961,0,0,Southern,7,3,1,2,2,9,11,8,10,32,54,6,11,Tyre Moore,16,Mercer,1,2,13,2016,2015
962,0,0,MEAC,4,6,5,10,1,1,11,3,4,20,91,7,5,Brock Moorman,16,North Carolina A&T,1,6,11,2011,2009
963,8,1,Horizon,8,5,1,10,4,9,19,2,2,28,106,3,13,Alek Mroziki,16,Youngstown State,1,8,11,2008,2007
964,6,1,WCC,7,6,5,8,1,7,15,3,8,20,77,1,8,Alex Mudronja,16,Saint Mary's (CA),4,11,8,2019,2019
965,32,1,OVC,19,7,7,18,0,7,25,2,6,18,208,4,19,Taariq Muhammad,16,Morehead State,15,29,23,2013,2013
966,6,0,SWAC,4,6,5,8,1,4,12,3,6,9,40,0,4,Josh Mullins,16,Grambling,2,0,4,2020,2020
967,1,5,Ivy,5,8,8,17,0,0,17,0,1,17,59,5,6,Kevin Mulquin,16,Dartmouth,1,3,10,2011,2011
968,0,0,Horizon,7,7,6,8,1,1,9,1,2,16,39,1,3,Andy Neff,16,Wright State,0,3,8,2020,2019
969,0,0,Big 12,7,6,3,8,3,6,14,1,4,14,40,3,7,Danny Newsome,16,Texas,0,3,10,2016,2013
970,2,2,Southern,17,7,7,18,0,0,18,2,5,15,64,6,13,Josh Nirenberg,16,Appalachian State,1,7,23,2011,2010
971,0,0,Southland,2,6,2,3,4,11,14,0,0,12,32,1,1,Nicholaus Osbourne,16,Texas-Arlington,4,3,3,2012,2012
972,3,3,SWAC,3,6,6,6,0,0,6,4,5,1,26,2,3,Kirk Parker,16,Southern,2,1,5,2020,2020
973,4,0,A-10,3,6,6,10,0,1,11,4,7,10,26,0,1,Trevin Parks,16,Charlotte,0,5,3,2010,2010
974,4,0,CUSA,8,5,2,4,3,15,19,3,5,16,75,3,10,Tyler Pate,16,Florida Atlantic,2,4,11,2014,2014
975,6,7,Horizon,20,8,8,22,0,0,22,0,0,18,172,11,23,Kye Pattrick,16,Loyola (IL),2,6,31,2007,2007
976,28,7,A-Sun,17,5,4,10,1,1,11,5,10,25,206,1,25,Cartree Pettis,16,Jacksonville,7,13,18,2016,2016
977,1,2,Patriot,9,6,2,7,4,19,26,0,0,16,57,0,8,Mark Pollack,16,Army,0,5,9,2018,2015
978,1,0,Big Sky,4,6,6,8,0,0,8,4,6,15,32,2,3,Marco Ramos,16,Weber State,0,0,6,2009,2009
979,22,1,Sun Belt,9,6,3,11,3,9,20,1,4,15,254,2,13,Lonell Reeves,16,Louisiana-Monroe,5,18,11,2011,2011
980,2,0,Southern,6,7,7,16,0,0,16,2,4,20,86,8,14,Matt Roberts,16,Citadel,0,6,14,2009,2009
981,11,3,Big 12,11,7,7,15,0,5,20,2,10,66,173,11,37,Brian Rohleder,16,Kansas State,8,7,22,2016,2012
982,1,2,SWAC,4,5,5,7,0,0,7,6,8,11,40,6,9,Billy Rosenberg,16,Texas Southern,0,1,10,2013,2013
983,1,3,MAAC,12,5,5,16,0,0,16,6,12,24,112,16,17,Marcelo Ruediger,16,Monmouth,2,6,28,2014,2014
984,3,0,CAA,5,5,3,6,2,3,9,4,6,21,43,3,4,Connor Rufo,16,Delaware,0,1,8,2019,2018
985,2,1,Total,7,6,5,6,1,8,14,3,4,12,32,2,2,Patrick Ryan,16,Elon,0,5,9,2017,2014
986,5,1,Summit,18,4,4,12,0,4,16,8,8,18,91,12,5,Zac Sadler,16,North Dakota,3,5,30,2020,2019
987,2,1,CUSA,3,5,3,5,2,7,12,4,7,42,43,2,2,Will Sanger,16,Tulsa,1,4,5,2012,2009
988,4,5,Big West,16,6,6,22,0,0,22,4,8,39,135,13,32,Quentin Shropshire,16,Cal State Long Beach,3,4,29,2018,2016
989,8,1,SEC,16,6,2,3,4,13,16,0,0,32,90,1,5,Jordan Smart,16,Vanderbilt,2,1,17,2012,2010
990,1,1,Big Ten,6,6,4,12,2,13,25,2,3,39,76,4,5,Jordan Smith,16,Wisconsin,0,1,10,2016,2012
991,1,0,CUSA,2,6,4,6,2,9,15,2,5,7,42,3,5,Phillip Smith,16,Florida International,3,1,5,2019,2019
992,0,1,A-10,6,7,7,14,0,0,14,2,3,15,83,7,16,Nick Stafford,16,Dayton,3,9,13,2007,2007
993,3,2,MEAC,5,6,6,12,0,0,12,4,4,24,79,1,9,Hefeng Sun,16,Norfolk State,1,3,6,2015,2014
994,2,0,Big Sky,3,6,3,5,3,6,11,1,2,11,48,0,5,Clint Thomas,16,Idaho State,0,1,3,2014,2014
995,1,0,Big South,16,8,8,15,0,0,15,0,2,31,153,12,19,Colby Trent,16,Radford,2,5,28,2008,2007
996,5,5,A-10,34,8,8,24,0,0,24,0,4,24,176,14,18,Daymon Warren,16,George Washington,5,10,48,2011,2011
997,0,0,Horizon,3,5,1,3,4,12,15,2,2,15,51,1,4,Nick Weaver,16,Cleveland State,3,0,4,2008,2008
998,0,1,Big West,1,8,8,11,0,0,11,0,1,9,33,4,7,Bernard Webb,16,Cal State Fullerton,0,5,5,2012,2012
999,0,1,Big Sky,4,6,5,11,1,4,15,3,5,7,65,0,8,Justin Wesolowski,16,Northern Colorado,1,4,4,2009,2009
